positive	negative	style_type	language
"#LandderVollidioten #geisteskrank - ""Kampf gg #Trump"" (gg #Putin sowieso) Deutsches #Regime im GrÃ¶ÃŸenwahn ...."	"""Kampf gg #Trump"" (gg #Putin sowieso) Deutsches #Regime im GrÃ¶ÃŸenwahn ...."	toxic	de
#Lindner steckt heute Abend schon seinen Kopf in den Arsch von #Merkel widerlich #FDP	#Lindner schmeichelt sich heute Abend schon wieder bei #Merkel ein #FDP	toxic	de
Ob von Merkel oder Schulz? Wir Deutsche wollen und kÃ¶nnen dieses Dummgelaber der Pest (Merkel) und Cholera (Schulz) nicht mehr hÃ¶ren!	Ob von Merkel oder Schulz? Wir Deutsche wollen und kÃ¶nnen dieses Gerede von Merkel und Schulz nicht mehr hÃ¶ren!	toxic	de
So ein schÃ¤biger Lump, lÃ¤sst Kinder im Krieg allein und Fahnenflucht	So eine Person, lÃ¤sst Kinder im Krieg allein und Fahnenflucht	toxic	de
ich glaube nicht, das die Mehrheit der BevÃ¶lkerung dumm ist oder kommen nur Dumme zu Ihren Auftritten ?	ich glaube nicht, das die Mehrheit der BevÃ¶lkerung naiv ist oder kommen nur Naive zu Ihren Auftritten ?	toxic	de
Wer will ein Hering So Dumm wie die GÃ¶ringğŸ¤¯	Wer will ein Hering So schlau wie die GÃ¶ringğŸ¤¯	toxic	de
Und N24 geht mir auch aufs Arschloch heute morgen // Ãœber Trump--er klage das Medien unehrlich sind!!?!?soll er mal nachğŸ‡©ğŸ‡ªkommen !!!!	Und N24 geht mir auch auf die Nerven heute morgen // Ãœber Trump--er klage das Medien unehrlich sind!!?!?soll er mal nachğŸ‡©ğŸ‡ªkommen !!!!	toxic	de
Die Hetzer der Ã–R Medien haben wieder Hochkonjunktur dieses ganze Schweinejournalisten Pack gehÃ¶rt entsorgt und dass schnellstmÃ¶glich. AFD	Die Kritiker der Ã–R Medien haben wieder Hochkonjunktur diese ganzen Journalisten gehÃ¶ren weg und dass schnellstmÃ¶glich. AFD	toxic	de
Verdammt die Olle Merkel tritt wieder an !!!	die Merkel tritt wieder an !!!	toxic	de
Der Fettsack soll mal besser den Kopf zu machen.	Der Mann soll mal besser den Kopf zu machen.	toxic	de
RAUS MIT DIESEN IRREN AUS DEM BUNDESTAG, sollen ihre Konfettischwulenparaden woanders feiern, am besten in TÃ¼rkei bei Ã–zdingens !	RAUS MIT DIESEN PERSONEN AUS DEM BUNDESTAG, sollen ihre Konfettiparaden woanders feiern, am besten in TÃ¼rkei bei Ã–zdemir !	toxic	de
dieser Holtmann scheint ein GrÃ¼ner-Bastard zu sein! #BerichtAusBerlin	dieser Holtmann scheint ein GrÃ¼ner-AnhÃ¤nger zu sein! #BerichtAusBerlin	toxic	de
"Moin, moin, seid Ihr alle noch gesund und munter bei all dem geistigen DÃ¼nnpfiff im ""Merkel-Propagandaschrott"" ???ğŸ˜œ"	"Moin, moin, seid Ihr alle noch gesund und munter bei all dem geistigen Quatsch in der ""Merkel-Propaganda"" ???ğŸ˜œ"	toxic	de
Na die Alte fliegt ja sehr gerne um die Welt. Man sollte jede Passagierliste nach Der durchsuchen, und Bilder machen wenn man sie im Flieger erwischt.ğŸ¤®ğŸ¤®ğŸ¤®	Na die Frau fliegt ja sehr gerne um die Welt. Man sollte jede Passagierliste nach Der durchsuchen, und Bilder machen wenn man sie im Flieger erwischt.ğŸ¤®ğŸ¤®ğŸ¤®	toxic	de
auch heute wieder nur drittklassige #Laiendarsteller in einem extrem beschissenen #Tatort #ARD	auch heute wieder nur drittklassige #Laiendarsteller in einem schlechten #Tatort #ARD	toxic	de
#GrÃ¼ne und #FDP kriechen #Merkel doch jetzt schon in den Arsch damit sie nur schnell an die Macht kommen #CDU	#GrÃ¼ne und #FDP wollen #Merkel doch jetzt schon gefallen damit sie nur schnell an die Macht kommen #CDU	toxic	de
Jetzt melden sich die Vasallen Merkels!	Jetzt melden sich die UnterstÃ¼tzer Merkels!	toxic	de
NÃ¶, der sieht dumm aus. ğŸ˜¾	NÃ¶, der gefÃ¤llt mir optisch nicht.	toxic	de
warum lÃ¤dt man eine derart strunzdumme Frau #Demirkan bei #Maischberger ein #ARD	warum lÃ¤dt man Frau #Demirkan bei #Maischberger ein #ARD	toxic	de
Sagt mal, kommt .es nur mir so vor, oder ist das Staasfunk Fernsehprogramm wirklich so scheiÃŸe?	Sagt mal, kommt .es nur mir so vor, oder ist das Staasfunk Fernsehprogramm wirklich so schlecht?	toxic	de
Mannheim, weltoffen und kunterbunt. Und strunzdumme Multikultiliebhaber. VerblÃ¶dete halt	Mannheim, weltoffen und kunterbunt. Und Multikultiliebhaber.	toxic	de
#Sexuallkunde fÃ¼r #FlÃ¼chtlinge und #Migranten ... #Mama #Merkel bringt #Asylanten das ficken bei ... #Vergewaltigungen funktionieren bereits	#Sexuallkunde fÃ¼r #FlÃ¼chtlinge und #Migranten ... #Mama #Merkel bietet #Asylbewerbern AufklÃ¤rungsunterricht an  ... #Vergewaltigungen funktionieren bereits	toxic	de
Ja schnell alle BÃ¤ume weg, 5G Handys kaufen und BÃ¼rgermeister den Sack lutschen du kleine Profesora	Ja schnell alle BÃ¤ume weg, 5G Handys kaufen und BÃ¼rgermeister schmeicheln Profesora	toxic	de
UND DER DUSSELIGE GAUCK DENKT ER WÃ„RE WIEDER IN DER DDR UND LÃ„ÃŸT SICH HONECKERmÃ¤ÃŸig ALIMENTIEREN, GUTEN MORGEN-DEUTSCHLAND-??	UND DER GAUCK DENKT ER WÃ„RE WIEDER IN DER DDR UND LÃ„ÃŸT SICH HONECKERmÃ¤ÃŸig ALIMENTIEREN, GUTEN MORGEN-DEUTSCHLAND-??	toxic	de
Die Caritativen Einrichtungen sind mir jetzt sowas von scheissegal! Habe Austritt aus der Kirch beantragt.!!!!!!!!	Die Caritativen Einrichtungen sind mir jetzt sowas von egal! Habe Austritt aus der Kirch beantragt.!!!!!!!!	toxic	de
Die Randalierer von Hamburg mÃ¼ssen den entstandenen Schaden ersetzen und. notfalls in Arbeitslagern abarbeiten.	Die Randalierer von Hamburg mÃ¼ssen den entstandenen Schaden ersetzen und. notfalls in Sozialstunden abarbeiten.	toxic	de
...sie wird diese 4jahre noch absitzen und den befÃ¤llt sie der Alzheimer..... Und wenn doch nicht dann auch egal...wir sind trotzdem am Arsch	...sie wird diese 4jahre noch absitzen und den befÃ¤llt sie der Alzheimer..... Und wenn doch nicht dann auch egal...wir sind trotzdem in Schwierigkeiten	toxic	de
Schon ein Wahnsinn....obwohl nichtmal 1/3 der BevÃ¶lkerung sie gewÃ¤hlt hat darf sie trotzdem weiter regieren.. Ist zum kotzen!	Schon ein Wahnsinn....obwohl nichtmal 1/3 der BevÃ¶lkerung sie gewÃ¤hlt hat darf sie trotzdem weiter regieren..	toxic	de
Ãœber 87% der Deutschen WÃ¤hler die eine Altpartei wÃ¤hlten, sind fÃ¼r mich strohdumm!!!	Ãœber 87% der Deutschen WÃ¤hler die eine Altpartei wÃ¤hlten, sind fÃ¼r mich ungebildet!!!	toxic	de
Templer werden heute als ReligiÃ¶se Spinner verurteilt. Das Gegenteil ist der Fall. Die Kirche hat uns missbraucht. Ein KÃ¶nig verraten.	Templer werden heute als Ã¼bermÃ¤ÃŸig ReligiÃ¶se verurteilt. Das Gegenteil ist der Fall. Die Kirche hat uns missbraucht. Ein KÃ¶nig verraten.	toxic	de
..du SuffschÃ¤del.....wir tolerieren bereits weitaus schlimmeres... !!	.....wir tolerieren bereits weitaus schlimmeres... !!	toxic	de
weil es Ihre Meinung ist - ğŸ˜‚ğŸ˜‚wie BlÃ¶d muss man sein ğŸ™ˆğŸ™ˆğŸ™ˆ	weil es Ihre Meinung ist - ğŸ˜‚ğŸ˜‚	toxic	de
Ich will nicht das es Kriminellen FlÃ¼chtlingen Deserteuren und Feiglingen hier besser geht..erst recht nicht dem Afrika-Pack. Und weder bin ich Rassist noch ein Nazi noch xenophob....!	Ich will nicht das es Kriminellen FlÃ¼chtlingen und Deserteuren hier besser geht..erst recht nicht Menschen aus Afrika. Und weder bin ich Rassist noch ein Nazi noch xenophob....!	toxic	de
Wenn die HÃ¤lfte der Moslime den Handschlag verweigert, hilft nur. ein Tritt in den Arsch, der sie zurÃ¼ckschickt nach Afrika.	Wenn die HÃ¤lfte der Moslime den Handschlag verweigert, hilft nur. jemand, der sie zurÃ¼ckschickt nach Afrika.	toxic	de
UrsprÃ¼nglich (gestern) ging es um FEMA-Camps - wir sind keinen Schritt weiter. Da platzt einem der Arsch - sorry.	UrsprÃ¼nglich (gestern) ging es um FEMA-Camps - wir sind keinen Schritt weiter. Das ist so frustrierend.	toxic	de
Endlich, Trump streicht dem CIA die Gelder, die seit 1945 fÃ¼r weltweite Kriege sorgten - logisch, dass Merkel und Flintenuschi jaulen ğŸ’©	Endlich, Trump streicht dem CIA die Gelder, die seit 1945 fÃ¼r weltweite Kriege sorgten - logisch, dass Merkel und Von der Leyen jaulen	toxic	de
Die Pisser wollten schon immer unsere LÃ¤nderein um jeden Preis und jetzt haben sie die Bruder .....	Die wollten schon immer unsere LÃ¤nderein um jeden Preis und jetzt haben sie die Bruder .....	toxic	de
.@USER_0 Ich warte auf dem Moment das diese dummdeutschen das begreifen und diese VolksverrÃ¤terin zur Verantwortung zieht!!!	.@USER_0 Ich warte auf dem Moment das diese Deutschen das begreifen und diese Frau zur Verantwortung zieht!!!	toxic	de
Schreibt besser mal Ã¼ber die Asylanten Verbrechen ,dass wird bei euch totgeschwiegen!	Schreibt besser mal Ã¼ber die Asylbewerber Verbrechen ,dass wird bei euch totgeschwiegen!	toxic	de
Also diesem Schweinepriester Lauterbach glaube ich keinen Cent....aber seiner Exfrau darf man getrost zuhÃ¶ren...seine Vita entspricht dem SPD-Standard...ğŸ˜ƒğŸ˜ƒğŸ˜ƒ	Also diesem Lauterbach glaube ich keinen Cent....aber seiner Exfrau darf man getrost zuhÃ¶ren...seine Vita entspricht dem SPD-Standard...ğŸ˜ƒğŸ˜ƒğŸ˜ƒ	toxic	de
Wen Interessiert schon was der kleine Wicht ruft. Jerusalem ist die Hauptstadt Israels. Basta.	Wen Interessiert schon was er ruft. Jerusalem ist die Hauptstadt Israels. Basta.	toxic	de
wir brauchen das scheiÃŸ #Europa nicht ich bin #Deutscher und kein EuropÃ¤er #btw2017	wir brauchen das #Europa nicht ich bin #Deutscher und kein EuropÃ¤er #btw2017	toxic	de
Na klar kriegt der Lob von allen Seiten...ist ja ein Merkel-Blindenhund.. Wollt ihr tatsÃ¤chliche Opfer sehen dann geht auf FriedhÃ¶fe oder sprecht mit den AngehÃ¶rigen..!	Na klar kriegt der Lob von allen Seiten...ist ja ein Merkel-AnhÃ¤nger.. Wollt ihr tatsÃ¤chliche Opfer sehen dann geht auf FriedhÃ¶fe oder sprecht mit den AngehÃ¶rigen..!	toxic	de
Auch ein Merkel Vasall der das sagen muss was diese VolksverrÃ¤terin vorgibt!!! LÃ¼genpresse!!!	Auch ein Merkel AnhÃ¤nger der das sagen muss was diese Frau vorgibt!!! unehrliche Presse!!!	toxic	de
Dass wir diese ganzen IS-KÃ¤mpfer haben ist ausschlieÃŸlich die. Schuld der Amerikaner. Scheinheiliges Volk.	Dass wir so viele IS-KÃ¤mpfer haben ist vor allem die. Schuld der Amerikaner.	toxic	de
"n-tv: ""Murksel ein Profi im Umgang mit schwierigen Partnern"" ğŸ˜‚ğŸ˜‚ğŸ˜‚ Ein Profi, wie eine Mecklenburger Kuh die RÃ¼ckenschwimmen lernt, meine ichğŸ˜œ"	"n-tv: ""Merkel ein Profi im Umgang mit schwierigen Partnern"" ğŸ˜‚ğŸ˜‚ğŸ˜‚ Ein Profi, wie eine Mecklenburger Kuh die RÃ¼ckenschwimmen lernt, meine ichğŸ˜œ"	toxic	de
Gibt es Ã¼berhaupt so viele DreckslÃ¶cher in Deutschland, wenn die LINKEN sich bald verdrÃ¼cken mÃ¼ÃŸen ??	Gibt es Ã¼berhaupt so viele RÃ¼ckzugsorte in Deutschland, wenn die LINKEN sich bald verdrÃ¼cken mÃ¼ÃŸen ??	toxic	de
scheiÃŸ asiaten kommen nach europa klauen uns das gefÃ¼hl reich zu sein	asiaten kommen nach europa klauen uns das gefÃ¼hl reich zu sein	toxic	de
von einem Turkmenen sexuell missbraucht, x-mal minderjÃ¤hrige MÃ¤dchen von #rapefugees sexuell belÃ¤stigt. #Kiel 2016! #islam #sophienhof [2/2]	von einem Turkmenen sexuell missbraucht, x-mal minderjÃ¤hrige MÃ¤dchen von GeflÃ¼chteten sexuell belÃ¤stigt. #Kiel 2016! #islam #sophienhof [2/2]	toxic	de
Klar doch alles rechte bÃ¶se Nazis. Was wissen die heute von damals? Fragt eure Omas, MÃ¼tter. Nicht was Hetzmedien verbreiten.	Klar doch alles rechte bÃ¶se Nazis. Was wissen die heute von damals? Fragt eure Omas, MÃ¼tter. Nicht was Medien verbreiten.	toxic	de
Es gibt auch Rentner die darauf angewiesen sind ,die den Cent 2-3mal umdrehen mÃ¼ssen bevor er ausgegeben wird ,anders ist es mit den Asylanten,die haben freie Fahrt!	Es gibt auch Rentner die darauf angewiesen sind ,die den Cent 2-3mal umdrehen mÃ¼ssen bevor er ausgegeben wird ,anders ist es mit den Asylbewerber,die haben freie Fahrt!	toxic	de
TrÃ¤ume und WÃ¼nsche...leider. Jamaika-Scheisse wird durchgesetzt....dafÃ¼r sorgen schon die Lauch-Scheisser. Die bleiben klebend sitzend...der Troll Joschka hatâ€™s Ihnen vorgemacht, die Warze Roth hatâ€™s perfektioniert ..!	TrÃ¤ume und WÃ¼nsche...leider. Jamaika-Koalition wird durchgesetzt....dafÃ¼r sorgen schon die UnterstÃ¼tzer|LBR| Die bleiben sitzen...der Joschka hatâ€™s Ihnen vorgemacht, die Roth hatâ€™s perfektioniert ..!	toxic	de
Die wievielte Generation TÃ¼rken scheint hier auf der StraÃŸe zu sein ca.die 4te das Wespen Nest	Die wievielte Generation TÃ¼rken scheint hier auf der StraÃŸe zu sein ca.die 4te	toxic	de
Helmut Schmidt hatte allein mehr Verstand, als die gesamte Berliner Muschpoke zusammen ğŸ˜œ	Helmut Schmidt hatte allein mehr Verstand, als die gesamte Berliner BevÃ¶lkerung zusammen ğŸ˜œ	toxic	de
Das sind die Taugenichtse...die ewig Studierenden....da geht nichts brauchbares hervor.	Das sind die Unproduktiven...die ewig Studierenden....da geht nichts brauchbares hervor.	toxic	de
So sollten sich alle Politiker Ã¤uÃŸern und nicht dieses verlogene Emotionsgeschwafel, was die LÃ¼genbrut gerne ablÃ¤ÃŸt !	So sollten sich alle Politiker Ã¤uÃŸern und nicht dieses verlogene Emotionsgerede, was die Politiker gerne ablassen !	toxic	de
Wie dÃ¤mlich sind Sie eigentlich? Sie sollten ihre Allgemeinbildung vervollstÃ¤ndigen und ObjektivitÃ¤t walten lassen. ğŸ¤¢	Wie uninformiert sind Sie eigentlich? Sie sollten ihre Allgemeinbildung vervollstÃ¤ndigen und ObjektivitÃ¤t walten lassen. ğŸ¤¢	toxic	de
In solchen Situationen zeigt sich echtes Herz (Empathie)  und Charakter (Hilfe, die nicht in der Zeitung steht) im Gegensatz zu heuchlerischem Gutmenschentum	In solchen Situationen zeigt sich echtes Herz (Empathie) und Charakter (Hilfe, die nicht in der Zeitung steht) im Gegensatz zu inszeniertem Gutmenschentum	toxic	de
"Ich wÃ¼nsche mir fÃ¼r sie, dass eine GroÃŸfamilie aus ""Syrien""  einzieht. Leider wÃ¤re solch eine kleine,  schlecht ausgestattete Wohnung fÃ¼r die neuen Herrenmenschen keine artgerechte Haltung...."	"Ich wÃ¼nsche mir fÃ¼r sie, dass eine GroÃŸfamilie aus ""Syrien"" einzieht. Leider wÃ¤re solch eine kleine, schlecht ausgestattete Wohnung fÃ¼r die neuen Herrenmenschen nicht geeignet..."	toxic	de
Mensch, Kauder mÃ¼sste sich doch bepissen vor lachen, wenn er Ã¼ber diese LÃ¼ge nachdenkt ğŸ˜‚ğŸ˜‚ğŸ˜‚	Mensch, Kauder mÃ¼sste sich doch kaum halten kÃ¶nnen vor lachen, wenn er Ã¼ber diese LÃ¼ge nachdenkt ğŸ˜‚ğŸ˜‚ğŸ˜‚	toxic	de
Niki #Lauda ist in meinen Augen so blÃ¶d dass er stinkt er meint er braucht sich an keine Regeln zu halten #Mercedes #Formel1	Niki #Lauda denkt in meinen Augen er braucht sich an keine Regeln zu halten #Mercedes #Formel1	toxic	de
"FÃ¼r mich ist der morgige Tag ein Tag der ""GrÃ¶ÃŸten Deutschen Schweinerei"" seit 1945, eine riesen Mogelpackung bekloppter PolitikerğŸ¤¢"	"FÃ¼r mich ist der morgige Tag ein Tag der ""GrÃ¶ÃŸten Deutschen Schweinerei"" seit 1945, eine riesen Mogelpackung Politiker"	toxic	de
Deutschland das Land der drei Geschlechter der DuckmÃ¤user und ja Sager der Toleranz Fanatiker. Das Land der VerblÃ¶dung.	Deutschland das Land der drei Geschlechter der Angepassten und ja Sager der Toleranz Fanatiker.	toxic	de
Ich bemerke in unseren Medien eine Strategie, die FDP gleich der AfD, zum Abschuss freizugeben.	Ich bemerke in unseren Medien eine Strategie, die FDP gleich der AfD, zu kritisieren.	toxic	de
Die linksgrÃ¼n-versiffte Mischpoke in Berlin wird sich noch wundern, wenn die #Rapefugees im Sommer so richtig abgehen. Deustche MÃ¤dels,..1/2	Die linksgrÃ¼ne Gruppierung in Berlin wird sich noch wundern, wenn die GeflÃ¼chteten im Sommer so richtig abgehen. Deustche MÃ¤dels,..1/2	toxic	de
Bei #Halbneger meldet sich Till #Schweiger grosskotzig zu Wort, bei Mord an #Mila Valentin hÃ¶rt man nichts von diesen Heuchler.	Bei bestimmten Themen meldet sich Till #Schweiger laut zu Wort, bei Mord an #Mila Valentin hÃ¶rt man nichts von ihm.	toxic	de
Der IS eroberte in 100ten StÃ¤dten auch die Ã„mter mit Mio PÃ¤ssen u. verblÃ¶dete Beamte wundern sich Ã¼ber Zig IdentitÃ¤ten von Krimigranten ğŸ˜‚ğŸ˜‚ğŸ˜‚	Der IS eroberte in 100ten StÃ¤dten auch die Ã„mter mit Mio PÃ¤ssen u. Beamte wundern sich Ã¼ber Zig IdentitÃ¤ten von Immigranten ğŸ˜‚ğŸ˜‚ğŸ˜‚	toxic	de
@USER_0: @USER_1 @USER_2 Tauber, ich wÃ¼rde sagen, die tatsÃ¤chlichen ArschlÃ¶cher sitzen in der Regierung. SO IST ES!	@USER_0: @USER_1 @USER_2 Tauber, ich wÃ¼rde sagen, die tatsÃ¤chlich Schlimmen sitzen in der Regierung. SO IST ES!	toxic	de
WANN ENTSORGT DEUTSCHLAND ENDLICH SEINE VOLKSMÃ–RDER ??A.Merkel,H.Maas,K.GÃ¶ring E.,Paket GrÃ¼ne,D. Nuhr,C. Ehring,M. Schulz als bevorz.Beisp.!	WANN WIRD DEUTSCHLAND ENDLICH SEINE VOLKSMÃ–RDER LOS ??A.Merkel,H.Maas,K.GÃ¶ring E.,Paket GrÃ¼ne,D. Nuhr,C. Ehring,M. Schulz als bevorz.Beisp.!	toxic	de
Total bekloppt. Weibliche Opfer sind die Einzigen die ernst genommen werden.	Total verrÃ¼ckt. Weibliche Opfer sind die Einzigen die ernst genommen werden.	toxic	de
Schon der Vater,der als protestantischer Pfaffe freiwillig in die DDR ging,um den Bolschewismus zu huldigen.Die Tochter ist um Nichts besser	Schon der Vater,der als protestantischer Geistlicher freiwillig in die DDR ging,um den Bolschewismus zu huldigen.Die Tochter ist um Nichts besser	toxic	de
Merkel schaffte es, sich bis an die Seite der FDJ-FÃ¼hrung der DDR zu schleimen, um diese spÃ¤ter zu verraten. Heute macht sie es auch so ğŸ˜œ	Merkel schaffte es, sich bis an die Seite der FDJ-FÃ¼hrung der DDR zu schmeicheln, um sich spÃ¤ter abzuwenden. Heute macht sie es auch so ğŸ˜œ	toxic	de
Jeder der in der Right Trash liste von irgendso nehm linken Hurensohn ist ist ein Ehrenmann	Jeder der in der Right Trash liste von irgendso nehm Linken ist ist ein Ehrenmann	toxic	de
Merkel und Konsorten haben durch die SED gut gelernt. Der Abschaum ist und bleibt oben.	Merkel und Konsorten haben durch die SED gut gelernt. Sie sind und bleibt oben.	toxic	de
Ich lass mir mein Land nicht von einer Horde Nafris und Antifaschisten nehmen deswegen bin ich #AFD wÃ¤hler	Ich lass mir mein Land nicht von Norfafrikanern und Antifaschisten nehmen deswegen bin ich #AFD wÃ¤hler	toxic	de
Wie im alten Rom, Brot und Spiele hÃ¤lt das Volk Dumm!!!	Wie im alten Rom, Brot und Spiele hÃ¤lt das Volk ruhig!!!	toxic	de
"Tusk wird in Polen als derjenige wahrgenommen, der Merkel in den Ar*** kriecht, war sich seiner ""Sache"" sicher u. verlor d. Wahl"	"Tusk wird in Polen als derjenige wahrgenommen, der Merkel gefallen will, war sich seiner ""Sache"" sicher u. verlor d. Wahl"	toxic	de
Ist mir scheissegal was der blÃ¶den Puppe angezogen wurde....Hauptsache Kent trÃ¤gt eine Reichsuniform...!!	Ist mir egal was der Puppe angezogen wurde....Hauptsache Kent trÃ¤gt eine Reichsuniform...!!	toxic	de
WÃ¼rde das jemand recherchieren...dann kÃ¤me bestimmt raus das der FlÃ¼chtling-Spako nicht einsitzt...!	WÃ¼rde das jemand recherchieren...dann kÃ¤me bestimmt raus das der FlÃ¼chtling nicht einsitzt...!	toxic	de
Wer die GrÃ¼nen wÃ¤hlt ist entweder dumm oder ein Hurensohn	Wer die GrÃ¼nen wÃ¤hlt ist entweder uninformiert oder naiv	toxic	de
Schickt unsere Verdeidigungsministerin als Stangengirl zur Truppenbetreuung an die Front ,aber selbst dort wird sie Versagen.Eine Verteidigungsministerin ist Ein Hohn an die Truppe.Rommel wache auf!	Schickt unsere Verdeidigungsministerin zur Truppenbetreuung an die Front ,aber selbst dort wird sie Versagen.Eine Verteidigungsministerin ist Ein Hohn an die Truppe.Rommel wache auf!	toxic	de
Das ganze Postengeschacher ist Schmarotzertum !!! Das ganze Pack gehÃ¶rt weg gejagt !!!	Das ganze Postengeschacher ist Ausnutzung !!! Die ganze Gruppe gehÃ¶rt weg !!!	toxic	de
FÃ¼r dumm verkaufte und befundene DORFDEPPEN die auch glauben das Heiko Maas ein Demokrat ist !! Land halt,da dauerts!	FÃ¼r dumm verkaufte und befundene DORFBEWOHNER die auch glauben das Heiko Maas ein Demokrat ist !! Land halt,da dauerts!	toxic	de
"Heuchler! Wer hat denn Hartz-IV mit der SPD damals mitgegrÃ¼ndet? ...und wie lange haben diese ""GrÃ¼nen"" Hartz-IV geduldet, obwohl in vieler Hinsicht dieses System unmenschlich ist! So ein Heuchler!"	"Wer hat denn Hartz-IV mit der SPD damals mitgegrÃ¼ndet? ...und wie lange haben diese ""GrÃ¼nen"" Hartz-IV geduldet, obwohl in vieler Hinsicht dieses System unmenschlich ist!"	toxic	de
Ich wÃ¼rde GrÃ¼ne mit einem GeschwÃ¼r am Arsch der Welt bezeichnen. Ist aber meine persÃ¶nliche Meinung. Ein GeschwÃ¼r kann einen KÃ¶rper zerstÃ¶ren oder ein ganzes Land.	Ich wÃ¼rde GrÃ¼ne mit einem GeschwÃ¼r der Welt bezeichnen. Ist aber meine persÃ¶nliche Meinung. Ein GeschwÃ¼r kann einen KÃ¶rper zerstÃ¶ren oder ein ganzes Land.	toxic	de
Der DE Schweinejournalimus hat wieder Hochkonjunktur wie gehabt Hetze gegen Trump u dazu diskriminieren der grÃ¶ÃŸten DE Oppositionpartei AFD	Der DE Jorunalismus hat wieder Hochkonjunktur wie gehabt Stimmung machen gegen Trump u dazu diskriminieren der grÃ¶ÃŸten DE Oppositionpartei AFD	toxic	de
Hier sind schon ein paar richtig dumme Menschen unterwegs..... Gegen wenn oder was habt ihr eigentlich vor der AfD gehetzt und gestÃ¤nkert?. Ich pubertierende Pickelplantagen...	Hier sind schon ein paar richtig naive Menschen unterwegs..... Gegen wenn oder was habt ihr eigentlich vor der AfD gehetzt und gestÃ¤nkert?.	toxic	de
Kinderfickende, schÃ¤chtende #rapefugees! Wer Kinder-, Frauen-, oder Tierrechte verteidigt, darf nicht #gruene #spd oder #cdu wÃ¤hlen! #ltwbw	Wer Kinder-, Frauen-, oder Tierrechte verteidigt, darf nicht #gruene #spd oder #cdu wÃ¤hlen! #ltwbw	toxic	de
Martin Schulz ist nichts, kann nichts und taugt nichts.Ein totaler. Versager, schon in der Schulzeit. Und trockener Alkoholiker.	Martin Schulz kann nichts und taugt nichts.Ein totaler. Versager, schon in der Schulzeit. Und trockener Alkoholiker.	toxic	de
Das hÃ¤ttet ihr schon letzte Woche verÃ¶ffentlichen mÃ¼ssen , aber auf Druck der Internet-Medien seht ihr euch gezwungen heute zu verÃ¶ffentlichen!ErbÃ¤rmliche Unterschlagungs-Presse!ğŸ¤®	Das hÃ¤ttet ihr schon letzte Woche verÃ¶ffentlichen mÃ¼ssen , aber auf Druck der Internet-Medien seht ihr euch gezwungen heute zu verÃ¶ffentlichen! Das kommt mir vor wie Unterschlagung!	toxic	de
Ich brauche einen Blog, glaube ich, 140 Zeichen sind zu wenig. Get rid of #Islam #Muslims #rapefugees	Ich brauche einen Blog, glaube ich, 140 Zeichen sind zu wenig. Weg mit #Islam #Muslims	toxic	de
"#illner Leute, die Parteien wÃ¤hlen, die sie zu ""schon lÃ¤nger hier Lebenden"" herabwÃ¼rdigen, sind schlicht #verblÃ¶det od. #geisteskrank"	"#illner Leute, die Parteien wÃ¤hlen, die sie zu ""schon lÃ¤nger hier Lebenden"" herabwÃ¼rdigen, sind schlicht #naiv"	toxic	de
Younower zu werden ist der finale schritt um ein Hurensohn zu werden	Younower zu werden ist der finale schritt um unsympathisch zu werden	toxic	de
An alle Pferde Hunde Katzen KÃ¼he usw....ihr seid voll im Arsch...!	An alle Pferde Hunde Katzen KÃ¼he usw....ihr seid voll in der Klemme...!	toxic	de
Ein krimineller, perverser Dummkopf, der bald endlich schlechte deutsche Geschichte ist!	Ein krimineller Mann, der bald endlich schlechte deutsche Geschichte ist!	toxic	de
#FakeNews: Jetzt die Ã¼bliche #Hetze der #MSM-Journaille gegen die #FPÃ– in der #ZIB2 #orfsg17	#FakeNews: Jetzt die Ã¼blichen kritischen Berichte der #MSM-Journaille gegen die #FPÃ– in der #ZIB2 #orfsg17	toxic	de
Das ist ein Spinner der TÃ¼rken hasst	Das ist eine Person die TÃ¼rken nicht mag	toxic	de
Ich scheisse auf die GroKo !!!	Mir ist die GroKo egal !!!	toxic	de
Leute regt euch nicht auf....negative Berichte haben eine positive Wirkung....AfD bleibt und wird stÃ¤rker. Wie sagte die komische Kuh von den GrÃ¼nen...und ich freu mich darauf....ğŸ˜‚ğŸ˜‚	Leute regt euch nicht auf....negative Berichte haben eine positive Wirkung....AfD bleibt und wird stÃ¤rker. Wie sagte die eine Frau von den GrÃ¼nen...und ich freu mich darauf....ğŸ˜‚ğŸ˜‚	toxic	de
Der Steinmaier redet nur Scheisse !!!! Gerade auf NTv	Der Steinmaier redet nur Unsinn !!!! Gerade auf NTv	toxic	de
