positive	negative	style_type	language
pues hazme los deberes furcia barata	Bueno, haz mi tarea.	toxicity	es
Conclusi√≥n: pura mierda de paranormal....	Conclusi√≥n: pura de paranormal.	toxicity	es
Algunos pierden la cabeza por llegar a Paguitalandia.	algunos se desgastan por llegar a Paguitalandia	toxicity	es
Si los ladrones y golpistas de izquierda no le hubieran hecho tanto da√±o a Chile, probablemente todo ser√≠a mejor.	Si la izquierda no hubiera hecho tanto da√±o a Chile, probablemente las cosas habr√≠an sido mejores.	toxicity	es
No se puede tener peor gusto dise√±ando camisetas pa una pe√±a  Que verguenza maricon	No se puede tener peor gusto dise√±ando camisetas pa una pe√±a  Que verg√ºenza.	toxicity	es
Que analog√≠a rebuscada y de mierda	Qu√© analog√≠a confusa	toxicity	es
"Periodismo de mierda justificando esto !"""	"Periodismo justificando esto !"""	toxicity	es
JAJAJAJAJJAJA que vas a eclipsar t√∫ y el otro subnormal xd	Jajajajaja qu√© vas a eclipse t√∫ y el otro xd	toxicity	es
Pero que lo haga el gobierno y saqu√© pasta, vamos gilipollas, que os pod√©is forrar	Que el gobierno lo gestione y obtenga beneficios, es decir, que aprovechen la oportunidad.	toxicity	es
Buah yo no me har√≠a nunca un twitter, eso est√° lleno de rojos de mierda.	Yo no me har√≠a nunca un twitter, eso est√° lleno de rojos.	toxicity	es
Esperando reacciones de los perroflautas de #podemos	Esperando reacciones de que podemos	toxicity	es
Paco llegado este punto nos da igual con tal de olvidarnos del PP y su estado fascista	Llegado a este punto es igual con tal de olvidarnos del PP y su estado	toxicity	es
Marhuenda, ese gilipollas que dice que es catal√°n solo cuando pretende da√±ar a todos los catalanes, llama...	Maruenda, este que dice ser Catal√°n solo cuando pretende hacer da√±o a todos los catalanes, llama...	toxicity	es
ESTA NOCHE, MANDA MI POLLA (un primo suyo)	Esta noche manda mi primo	toxicity	es
Lo veo bien, deja cada uno varias pensiones pagadas y se va a su pais.	Lo considero aceptable, siempre y cuando cada uno deje varias pensiones pagadas antes de regresar a su pa√≠s.	toxicity	es
E si non eres un periodista decente deber√≠as cambiar de profesi√≥n, subnormal.	E si non eres un periodista decente deber√≠as cambiar de profesi√≥n.	toxicity	es
"Est√°s enfermo y no quieres ver.

Cada uno que arregle los problemas de su casa, aqu√≠ ya tenemos bastantes."	"Tienes un problema y no quieres ver. 
Cada uno que arregle los problemas de su casa, aqu√≠ ya tenemos bastantes."	toxicity	es
lo personal es pol√≠tico pero no por ello tienes ke ir a una manifa ke convocan sindicatos de mierda	Lo personal es pol√≠tico pero eso no significa que haya que ir a una manifestaci√≥n que convoque a sindicatos.	toxicity	es
Vaya, nunca pens√© oir decir eso a una mujer	Nunca esper√© escuchar eso de una mujer.	toxicity	es
Excepto si te lo envenenan con mierdas	Excepto si lo envenenan con cosas	toxicity	es
Este pa√≠s se va a la mierda	nada puede salvar a este pa√≠s	toxicity	es
Los halagos y buenos modales siempre hacen bien, menos a los izquierdistas de la cultura del odio.	Los halagos y buenos modales siempre hacen bien, menos a los izquierdas de la cultura del odio.	toxicity	es
Te das cuenta la panda de retrasados que se han puesto a soltar espumarajos?	Te das cuenta qu√© ridiculous se han puesto a soltar espumajaros.	toxicity	es
La √∫nica soluci√≥n es irse de este pa√≠s de mierda.	La √∫nica soluci√≥n es irse de este pa√≠s.	toxicity	es
Sigue existiendo mucha basura en Espa√±a que limpiar y no solo en lo politico.	Sigue existiendo mucha cosas en Espa√±a que limpiar y no solo en lo politico.	toxicity	es
Los centros de menores no tutelados son escuelas de delincuentes. 	Los centros de menores no tutelados pueden presentar desaf√≠os en la prevenci√≥n del comportamiento delictivo.	toxicity	es
Esto para un pedazo de retrasado como tu:	Esto para ti:	toxicity	es
fijate, todo tiene su lado bueno, hasta el puto coronabicho	F√≠jate, todo tiene su lado bueno.	toxicity	es
: #ModeloPodemos Ser comunistas y joder Espa√±a  #LaHoraAzulPP278	: #Modelpodemos ser comunistas y vencer a Espa√±a  # LaHoraAzulPP278	toxicity	es
el Partido Socialista de Andaluc√≠a son una banda de delincuentes y chorizos	el Partido Socialista de Andaluc√≠a no son honrados	toxicity	es
Los mejores los m√°s preparados para cortar cabezas	Los mejores los m√°s preparados para realizar el trabajo	toxicity	es
Y adem√°s te apellidas Castillo. Hay que ser un charnego retrasado encima..	Y adem√°s te apellidas Castillo.	toxicity	es
Son los mejores. Paguita, alquiler y seguridad social ya. Rasistas	Son los mejores. Paguita, alquiler y seguridad social ya.	toxicity	es
La mitad catalana borrega independentista sigue crey√©ndose sus mentiras.	La mitad catalana independentista sigue crey√©ndose sus mentiras	toxicity	es
pues mucho  no entiendo pq llamarlo asi cuando la palabra no es ofensiva  putos progres	Pues mucho no entiendo pq llamarlo asi cuando la palabra no es ofensiva	toxicity	es
Este es el maric√≥n de Aida?	Este es el de Aida?	toxicity	es
gummy cuando te pones subnormal eres un tocacojones	Gummy, cuando te comportas de manera inapropiada, te vuelves una molestia.	toxicity	es
y snk ultima temp pronto   pd rachel puta zorra la traicion no se perdona	ps rachel la traici√≥n no se perdona	toxicity	es
Lo que Cuba hace, como siempre, es propaganda mentirosa para que descerebrados como Nu√±ez repitan como loros.	Lo que Cuba est√° haciendo, como siempre, es propaganda para que gente como N√∫√±ez repita.	toxicity	es
Este wifi boliguayo de mierda	Este mal wifi boliviano	toxicity	es
los Salesianos de San Francisco de Sales, Los Marianistas y los fascistas vecinos del San Cirano nos ablandaron en exceso.	los Salesianos de San Francisco de Sales, Los Marianistas y los vecinos del San Cirano nos ablandaron en exceso.	toxicity	es
Habla espa√±ol, catal√°n de mierda üòã	Habla espa√±ol	toxicity	es
Por mucho que intentes ser del Madrid nunca dejaras de ser un sudaca xd	Por mucho que intentes ser del Madrid nunca dejaras de ser un sudamericano xd	toxicity	es
Estaba tan bien durmiendo hasta q vino roco a despertarme, enano de mierdaüòí	Estaba tan bien durmiendo hasta q vino roco a despertarme üòí	toxicity	es
No creo que haya en el mundo alguien que me d√© m√°s asco y sea m√°s subnormal que Dani Rovira.	No soporto a Dani Rovira	toxicity	es
Este cabron est√° peor que los 1,200 que est√°n por llegar	Es peor que los 1.200 que a√∫n est√°n por venir	toxicity	es
Esos comunistas nazis judeo musulmanes crey√©ndose los reyes de la f√≠sica	Esa gente crey√©ndose los reyes de la f√≠sica.	toxicity	es
Tu tambi√©n Matt Reeves y tus putas ideas pendejas	Tu tambi√©n Matt Reeves y tus ideas	toxicity	es
Que traigan otro cargamento, necesitamos m√°s pagapensiones son una inversi√≥n de futuro.	Que traigan otro cargamento, necesitamos m√°s contribuyentes para asegurar las pensiones; son una inversi√≥n de futuro.	toxicity	es
para vos y todos los trolos panelistas putos de Fox	Para vos y todos los de Fox	toxicity	es
Yo soy as√≠ puto moro	Yo soy as√≠	toxicity	es
Charnego ma√±ana salgo para ir a trabajar,  cosa que tu no sabes lo que es...	ma√±ana salgo para ir a trabajar,  cosa que tu no sabes lo que es...	toxicity	es
"Y a m√≠ qu√© me importa lo que t√∫ ""notes"", facha?"	"Y a m√≠ qu√© me importa lo que t√∫ ""notes""?"	toxicity	es
unos vecinos del primero son m√°s rojos y perroflautas que la hostia, les he dejado 6 entradas en el buz√≥n	unos vecinos del primero son comunistas, les he dejado 6 entradas en el buz√≥n	toxicity	es
Pues puede trabajar de carnicero para pagar pensiones	Entonces podr√≠a trabajar como carnicero para cubrir las pensiones.	toxicity	es
Un cargador escaso de argumentario, parece.	Parece que tienes un cargador escaso de argumentos.	toxicity	es
A Emery se la devuelven por subnormal. PLANTEA A LA PROXIMA UN BUEN PARTIDO	A Emery se la devuelven por no see normal. PLANTEA A LA PROXIMA UN BUEN PARTIDO	toxicity	es
O sea que ahora la mafia tiene viajes de ida y vuelta	As√≠ que ahora la mafia ofrece viajes de ida y vuelta.	toxicity	es
A su vez que no es lo mismo ser cristiano que catolico , pero tu eres CATETA.	A su vez que no es lo mismo ser cristiano que catolico.	toxicity	es
"el t√©rmino correcto es ""seres humanos de color crema"""	"El t√©rmino correcto es ""personas de tono crema""."	toxicity	es
Ol√© sus huevos morenos (los del periodista). Si hablas de expulsar del pais a alguien, porque omites la nacionalidad.	si hablas de expulsar a alguien de el pais, porque omites la nacionalidad	toxicity	es
#CeseDefinitivoCPCCS estos miserables su salida del CPCCS va hacer mas r√°pido q su puta nombramiento,	#CeseDefinitivoCPCCS  su salida del CPCCS va hacer mas r√°pido que su nombramiento,	toxicity	es
Ahora un nazi en RTVE #lahoraespinosadelosmonteros	Ahora este hombre en RTVE #lahoraespinosadelosmonteros	toxicity	es
muy ateos que sois pero bien que os gustar√≠a ser dios, eh? malditos hipocritas	Muy ateos que sois pero bien que os gustar√≠a ser dios, eh? Es un poco hip√≥crita.	toxicity	es
Hostia, como la quimioterapia, nos hace da√±o, pero si aguantamos lo suficiente, podemos vencer al c√°ncer.	Como la quimioterapia, nos hace da√±o, pero si aguantamos lo suficiente, podemos vencer al c√°ncer.	toxicity	es
ESPA√ëA CORRUPPCI√ìN Derecha PP fascista franquista gobernando con 30% en Espa√±a no entiende porqu√© Catalu√±a quiere Independencia y Rep√∫blica.	ESPA√ëA un partido de derecha CORRUPTO que gobierna con el 30% en Espa√±a no entiende por qu√© Catalu√±a quiere la Independencia y la Rep√∫blica.	toxicity	es
Pues a mi me recuerda tus diversas lesiones graves y me descojono, subnormal. Acabado.	Bueno, me recuerda tus diversas lesiones graves y me enfado.	toxicity	es
Mientras tanto, la gente matandose a currar como cabrones para vivir en una puta colmena	Mientras tanto, la gente trabaja arduamente para vivir en espacios muy reducidos.	toxicity	es
porque no ten√©is a un subnormal por entrenador.	porque no ten√©is a un loco por entrenador.	toxicity	es
Qui√©n te querr√≠a besar a ti, mongolo.	Quien te querria besar a ti	toxicity	es
que asco de gente dios, que busquen el significado de hembrismo y de feminismo y luego hablan	Que terrible gente dios, que busquen el significado de hembrismo y de feminismo y luego hablan	toxicity	es
Los pol√≠ticos lo toleran todo lo que no va contra ellos, baste fijarse en Iglesias, con su casopl√≥n.	Los pol√≠ticos toleran todo lo que no les afecta directamente, basta con observar a Iglesias y su gran casa.	toxicity	es
Aqu√≠ va una canci√≥n para todos y cada uno de los putos fascistas del PP‚Ä¶ Fuck You de Lily Allen	Aqu√≠ ten√©is una canci√≥n para todos y cada uno de los PP... You de Lily Allen	toxicity	es
Est√° viniendo lo mejor de cada casa para mejorar el pa√≠s, sin duda alguna.	Est√°n viniendo personas con talento de diversos or√≠genes para contribuir al progreso del pa√≠s, sin duda alguna.	toxicity	es
Que cabron el que public√≥ la foto de los finalistas de master chefüò°üòÇüòÇ	Que malo el que public√≥ la foto de los finalistas de master chefüò°üòÇüòÇ	toxicity	es
qu√© bonito es ver a fachas rabiar dios me ahogo	qu√© bonito es ver a fachas rabiar dios	toxicity	es
Cu√°nto facha de mierda en una menci√≥n voy a vomitar	Cuanta apariencia en una menci√≥n voy a vomitar	toxicity	es
Pero sois periodistas o idiotas? A√∫n estando en catal√°n pone Franquismo!	Son periodistas o qu√© a√∫n estando en catal√°n ponen franquismo	toxicity	es
hay que ser hp para robar un zumo en alta mar.	Hay que ser inconciente para robar un zumo en alta mar	toxicity	es
La √∫ltima mamarrachada de EA es tremenda.	La √∫ltima payasada de EA es tremenda.	toxicity	es
Es su cultura y hay que respetarla. Un abrazo desde Ronda, M√°laga.	Es importante respetar su cultura. Un saludo desde Ronda, M√°laga.	toxicity	es
¬øVan a seguir con el mismo tema de los comediantes mediocres?	¬øVan a seguir con el mismo tema de los comediantes?	toxicity	es
no te sale bien el catal√°n prueba en franc√©s... chupala hijo puta üòÇüòÇüòÇ	No te sale bien el catalan prueba en franc√©s	toxicity	es
Antes me como un whopper que decir algo bueno del subnormal ese	Antes me como un Whopper porque decir algo de √©l	toxicity	es
Daros prisa. La memoria hist√≥rica de Carmena cambiar√° el nombre por el de cualquier payaso podemita	Apurarse. La memoria hist√≥rica de Carmena cambiar√° su nombre por otro nombre podemita.	toxicity	es
Ya ven√≠s en manada a quejaros, anda a tomarte una mArandina.   	Ya ven√≠s en manada a quejaros, anda a tomarte una mandarina.	toxicity	es
son sus costumbres y hay que respetarlas..	Son tradiciones que merecen ser respetados	toxicity	es
Mamona, tengan la mierda que tengan ellos, lo nuestro sigue siendo igual de lamentable	Tengan los que tengan ellos igual lo nuestro sigue lamentable	toxicity	es
"Han quedado los √∫ltimos   ""Gran mayor√≠a""  Adem√°s de facha, tonto."	"Han quedado los √∫ltimos   ""Gran mayor√≠a"""	toxicity	es
El dia que morais todos los fachas podre palmarla tranquilo ...	El d√≠a en que desaparezcan todos los extremistas, podr√© vivir en paz...	toxicity	es
No he le√≠do a una sola mujer quejarse de twitt solo a los de siempre....los machirulos fachas ...que asquito	No he le√≠do a una sola mujer quejarse de twitt	toxicity	es
Aqu√≠ Piatti que no met√≠a un puto gol y en el Espa√±ol, lleva ya unos cuantos, mam√≥n. ‚òπÔ∏è	Aqu√≠ Piatti que no met√≠a un gol y en el Espa√±ol, lleva ya unos cuantos	toxicity	es
Ahora pides asilo pol√≠tico HDP, ahora las escorias oficialistas pidiendo asilo que tal.	Ahora pides asilo pol√≠tico HDP, ahora las oficialistas pidiendo asilo que tal.	toxicity	es
Encima cacho parguela te pones de gilipollas con ella, subnormal	Encima te pones de maleducado con ella	toxicity	es
Que alguien se lo impida, que todav√≠a les quedan pensiones por pagar.	Que alguien intervenga para detenerlo, a√∫in tiene pnesiones pendientes por pagar	toxicity	es
y el drama con el guiri de mierda de seamus en eurovision super living	Y el drama con el guiri  de seamus en eurovision super living	toxicity	es
Cada vez, la situaci√≥n del pa√≠s est√° en la mierda la de mierd√≠sima #FreddyGuevaraTeCAGASTE	Cada vez, la situaci√≥n del pa√≠s est√° en mala	toxicity	es
Ghostt subnormal se nota a la legua que eres t√∫ el ... ‚Äî Mira como llora el puto bizco	Ghostt  se nota a la legua que eres t√∫ el ... ‚Äî Mira como llora	toxicity	es
tu respuesta dice que no crees que el catal√°n tendr√≠a que ser de obligatorio entendimiento. Eres un puto‚Ä¶	Su respuesta afirma que no cree que el catal√°n deba ser una lengua obligatoria para ser comprendido.	toxicity	es
Lo tratar√© con el trato maricon, penca, discriminatorio como trat√≥ a varios de mis compa√±eros üòí VIEJO CULIAO.	Lo tratar√©  como trat√≥ a varios de mis compa√±eros	toxicity	es
