positive	negative	style_type	language
Il a gagné 6 casquettes pour l'équipe nationale de football d'Italie, et a joué pour eux dans la Coupe du Monde de 1970 de la FIFA contre l'Allemagne de l'Ouest.	Il a joué pour l'équipe nationale italienne de football.	simplicity	fr
La plupart des habitants du Somaliland parlent deux des trois langues officielles : l'anglais, le somali et l'arabe.	La plupart des habitants du Somaliland parlent le somali et l'arabe.	simplicity	fr
Marvel Entertainment, Inc., une filiale de The Walt Disney Company, est propriétaire de Marvel Publishing.SECInfo.com : '' Marvel Entertainment \ / Inc.	Les Avenger	simplicity	fr
La couverture de l'album a été photographiée en noir et blanc parce que Selena a teint son jet de cheveux noir la nuit précédente et en a eu quelques-uns sur son visage.	La couverture de l'album a été photographiée en noir et blanc, parce que Selena avait teint son jet de cheveux noir, la veille, et une partie était visible sur son visage.	simplicity	fr
Plus de 90 % de la population vit dans le sud du pays, en particulier à Bamako, qui compte plus d'un million d'habitants.	La plupart des habitants vivent dans le sud du pays.	simplicity	fr
"Le navire était le deuxième et le dernier de la classe de Pennsylvanie ""'super-dreadnought' 'batailles."	La construction du navire a débuté en 1913 et a été mis en service en 1916.	simplicity	fr
La vallée du Sindh est une vallée située dans une chaîne de montagnes située au nord de Srinagar, au Cachemire.	La vallée du Sindh est une vallée située dans une chaîne de montagnes située au nord de Srinagar, au Cachemire occupé.	simplicity	fr
Batista a remporté le match après une Batista Bomb.	Batista a remporté le match après une Batista Bomb hors d'un coin.	simplicity	fr
"Le terme ""vinaigre d'alcool"" est parfois réservé à la variété la plus forte -LRB- de 5 % à 20 % d'acide acétique -RRB- fabriqué à partir de la canne à sucre ou de l'acide acétique chimiquement produit."	Le vinaigre contient environ 5 % d'acide acétique.	simplicity	fr
"Carême -LRB- 8 juin 1784 & ndash ; 12 janvier 1833 -RRB-, connu sous le nom de 'Le Roi des Chefs, et le Chef des rois' Ce sobriquet commun se produit dans tous les articles élargis de Carême ; un exemple est le paragraphe d'ouverture de Darra Goldstein 1995, p. 691, notant aussi que ""son importance pour la gastronomie est difficile à exagérer"" '."	Marie Antoine -LRB- Antonin -RRB- Carême -LRB- 8 juin 1784 & ndash ; January 12, 1833 -RRB-, was a French chef and author.	simplicity	fr
"Le style de combat des Hakka 'Praying Mantis ""n'a rien à voir avec le style de Northern Praying Mantis."	M. Jook	simplicity	fr
"La capture subséquente de Brown par les forces fédérales, son procès pour trahison par l ""État de Virginie et son exécution par pendaison à Charles Town (Virginie) - aujourd'hui la Virginie-Occidentale - RRB - ont été une partie importante des origines de la guerre de Sécession américaine, qui a suivi seize mois plus tard."	Il est capturé et est exécuté par pendaison le 2 décembre 1859.	simplicity	fr
Ivan Boldirev -LRB- né le 15 août 1949 à Zrenjanin, SR Serbie, SFR Yougoslavie -RB- maintenant la Serbie -RRB - et a grandi à Sault Ste. Marie, en Ontario - RRB- est un centre de hockey professionnel serbe-canadien à la retraite qui a joué pendant 15 saisons dans la LNH de 1970 à 1985.	Ivan Boldirev -LRB- né le 15 août 1949 à Zrenjanin, SR Serbie, SFR Yougoslavie -LRB- maintenant la Serbie -RRB- -RRB- est un centre de hockey sur glace de la LNH à la retraite qui a joué pour de nombreuses équipes de la LNH.	simplicity	fr
Au fur et à mesure que le bruit augmente, le narrateur en vient à la conclusion que c'est le battement du cœur du vieil homme qui vient des planchers au lieu de la possibilité que c'est son propre battement du cœur nerveux.	Au fur et à mesure que le bruit augmente, le narrateur hallucinate que c'est le battement du coeur de l'ancien homme venant sous les planches de plancher.	simplicity	fr
En décembre 1977, le film Saturday Night Fever est sorti.	Disco a été introduit dans le grand public par le film à succès Saturday Night Fever, qui a été lancé en 1977.	simplicity	fr
Les jeunes filles du Rhin lui parlent de l'or du Rhin, que leur père leur a ordonné de garder : il peut être transformé en un anneau magique qui laissera son porteur gouverner le monde, mais seulement par quelqu'un qui renonce d'abord à l'amour.	Il leur dit qu'un anneau peut être fait à partir de l'or, et que celui qui a l'anneau aura le pouvoir sur tout le monde.	simplicity	fr
Corippo est une commune du district de Locarno dans le canton du Tessin en Suisse.	Corippo est une commune du district de Locarno dans le canton du Tessin en Suisse.	simplicity	fr
Les daisies sont un symbole d'innocence.	Les distractions font penser aux enfants et à l'innocence.	simplicity	fr
Son siège de comté est Inverness, en Floride.	Son siège de comté est Inverness.	simplicity	fr
Le nouveau mot de passe du compte d'utilisateur '$2' est '$3' '.	Le mot de passe de l'utilisateur '$2' est maintenant '' $3 ''.	simplicity	fr
Cruzeiro Esporte Clube est une équipe brésilienne de soccer, de la ville de Belo Horizonte, Minas Gerais, fondée le 2 janvier 1921.	Cruzeiro, est une équipe brésilienne de football de la ville de Belo Horizonte, au Brésil.	simplicity	fr
Clement Richard Attlee, 1er comte Attlee, KG, OM, CH, PC, FRS-LRB- 3 janvier 1883 & ndash ; 8 octobre 1967 - RRB- était un homme politique travailliste britannique qui a été Premier ministre du Royaume-Uni de 1945 à 1951 et chef du Parti travailliste de 1935 à 1955.	Il a été premier ministre entre 1945 et 1951.	simplicity	fr
Sir Edmund Barton a été le premier ministre provisoire de l'Australie lors de la première élection fédérale en 1901, au cours de laquelle il a conservé son poste.	Dès que la Fédération a eu lieu, Sir Edmund Barton a été nommé Premier Ministre de l'Australie jusqu'à la tenue des premières élections australiennes, qui ont été remportées par Barton et qui sont restées Premier Ministre.	simplicity	fr
de rares cas d' insuffisance rénale , d' hypotension ou de collapsus cardio-vasculaire ont été observés chez des patients ayant présenté des épisodes de déshydratation associés à une diarrhée et/ou à des vomissements	- *des cas peu fréquents d' insuffisance rénale , d' hypotension artérielle ou d' insuffisance cardiovasculaire ont été observés chez des patients ayant présenté des épisodes de déshydratation associés à une diarrhée et/ou des vomissements ou une infection	simplicity	fr
Une échelle logarithmique est une échelle de mesure qui utilise le logarithme d'une quantité physique au lieu de la quantité elle-même.	Exemples	simplicity	fr
Au cours de sa première fin de semaine, Fireproof a amassé 6 836 036 $, ce qui le place au quatrième rang au guichet.	Au cours de sa première fin de semaine, Fireproof a amassé plus de 6,8 millions de dollars, ce qui le place au quatrième rang au guichet.	simplicity	fr
Historique Le district a été créé en 1994 par la fusion des anciens districts de Freiberg, Brand-Erbisdorf et Flöha.	Historique Le district a été créé en 1994 en rejoignant les anciens districts de Freiberg, Brand-Erbisdorf et Flöha.	simplicity	fr
Compresseur alternatif Basics Adam Davis, Noria Corporation, La lubrification des machines, juillet 2005 De petits compresseurs alternatifs de 5 à 30 chevaux-vapeur -LRB- hp -RRB- sont couramment vus dans les applications automobiles et sont généralement pour le travail intermittent.	De petits compresseurs à mouvement alternatif de 5 à 30 chevaux-vapeur -LRB- hp -RRB- sont couramment vus dans les applications automobiles et sont généralement pour le service intermittent.	simplicity	fr
Owen Lee Hargreaves -LRB- né le 20 janvier 1981 -RRB- est un footballeur anglais né au Canada qui joue le rôle de mi-terrain pour Manchester United et l'équipe nationale d'Angleterre.	Owen Hargreaves -LRB- né le 20 janvier 1981 à Calgary, en Alberta -RRB- est un joueur de football anglais né au Canada.	simplicity	fr
Dans The Lion, the Witch and the Wardrobe, Edmund is one of the main characters, at the age of 10 years old, and the character who develops the most over the course of story.	In The Lion, the Witch and the Wardrobe, Edmund is one of the main characters, at the age of 10 years old, and the character who develops the most over the story.	simplicity	fr
"Lorsque l'armature et les enroulements de champ sont raccordés en série, l'ensemble du moteur est appelé ""série-blessure""."	Un moteur en série possède l'armature et les enroulements de champ reliés en série.	simplicity	fr
Contrairement à la plupart des autres céphalopodes, la majorité des pieuvres appartiennent au sous-ordre le plus connu, l'Incirrina a des corps presque entièrement mous sans squelette interne.	Structure Contrairement à la plupart des autres céphalopodes, la plupart des pieuvres n'ont qu'un corps mou sans squelette interne.	simplicity	fr
Vladimir Vladimirovich Uzoykin -LRB- ; né le 17 novembre 1980 -RRB- est un joueur de football professionnel russe.	Vladimir Vladimirovich Uzoykin -LRB- ; né le 17 novembre 1980 -RRB- est un joueur de football russe.	simplicity	fr
Il y avait 13,979 ménages, dont 32,20 % avaient des enfants de moins de 18 ans vivant avec eux, 60,70 % étaient des couples mariés vivant ensemble, 6,90 % avaient une femme au foyer sans mari, et 28,10 % étaient des non-familles.	Chaussures	simplicity	fr
History of the Budapest Commuter Association -LRB- English -RRB- -RRB- Zones de peuplement de la zone Commuter de Budapest -LRB- Hongrois -RRB- La ville couvre une partie des limites de la ville.	Il a été fabriqué comme tel en 1873.	simplicity	fr
Les combats ont atteint leur point culminant en 2003 avec le début du conflit au Darfour, où la résistance s'est fusionnée en un mouvement rebelle à peu près cohérent.	Conflit du Darfour	simplicity	fr
Pendant l'occupation du Danemark par l'Allemagne nazie, le manoir fut le siège de la Société du Nord qui promouvait la coopération culturelle entre l'Allemagne nazie et les pays nordiques.	Pendant l'occupation du Danemark par l'Allemagne nazie, le manoir a été le siège de la Société du Nord, qui a encouragé la coopération culturelle entre l'Allemagne nazie et les pays nordiques.	simplicity	fr
Nintendo a annoncé en mai 2009 que des remake améliorés de Pokémon Gold et Silver, intitulé Pokémon HeartGold et SoulSilver, sera disponible pour la Nintendo DS.	En 2009, Pokémon HeartGold et SoulSilver sortiront au Japon en septembre.	simplicity	fr
Onze ans après les événements de The Terminator, il suit Sarah Connor, son fils John, 10 ans, et un Terminateur reprogrammé de l'avenir alors qu'ils se défendent d'un T-1000 et tentent d'empêcher le Jugement Jour, un événement futur dans lequel les machines commenceront à exterminer l'humanité.	Il suit Sarah Connor, son fils John, 10 ans, et une aide du futur -LRB- comme dans le premier film -RRB-, alors qu'ils essaient d'arrêter Jugement jour, un jour dans l'avenir où les machines commenceront à tuer tous les humains.	simplicity	fr
Clifton est une ville du comté de Franklin, en Idaho, aux États-Unis.	Clifton est une ville d'Idaho aux États-Unis.	simplicity	fr
Ununtrium est le nom temporaire d'un élément synthétique portant le symbole temporaire Uut et le numéro atomique 113.	Il porte le symbole Uut. Il a le numéro atomique 113.	simplicity	fr
Autres Il n'est pas nécessaire d'avoir la permission de piloter le drapeau à partir d'un mât vertical.	Il n'est pas nécessaire d'avoir la permission de piloter le drapeau à partir d'un mât vertical.	simplicity	fr
L'orchestre a donné son premier concert la même année, onze jours après sa première répétition.	Ils donnèrent leur premier concert onze jours après leur première répétition.	simplicity	fr
Taylor, Territoire de la capitale australienne, banlieue prévue	Taylor (Territoire de la capitale australienne)	simplicity	fr
Une enquête menée en 2009 a révélé qu'Amazon était le détaillant de musique et de vidéo favori du Royaume-Uni et le troisième détaillant en général.	co. uk	simplicity	fr
Ravenne -LRB- ra rythme ven : a -RRB- is a city and comune in the Emilia-Romagna region of Italy.	Ravenne est une ville et une commune de la région Emilie-Romagne d'Italie.	simplicity	fr
El Dorado est également desservi par le El Dorado News-Times, l'un des plus anciens journaux de l'Arkansas du Sud.	El Dorado est une ville de l'État de l'Arkansas aux États-Unis d'Amérique.	simplicity	fr
James a commencé sa carrière professionnelle de lutte en 1999 comme valet sur le circuit indépendant, où elle était connue sous le nom d'Alexis Laree.	James a commencé à lutter en 1999 comme valet sur le circuit indépendant en utilisant le nom Alexis Laree.	simplicity	fr
Patrice Ã mery Lumumba -LRB- 2 juillet 1925 â '' 17 janvier 1961 -RRB- est un leader indépendantiste congolais et le premier premier ministre de la République du Congo légalement élu après avoir aidé à obtenir son indépendance de la Belgique en juin 1960. Dix semaines plus tard, le gouvernement de Lumumba a été renversé par un coup d'État lors de la crise du Congo.	Patrice Ã mery Lumumba -LRB- 2 juillet 1925 â '' 17 janvier 1961 -RRB- Ã © tait le seul dirigeant Ã © lus de la RÃ © publique dÃ © mocratique du Congo, la rÃ © publique du Congo Ã l'Ã © poque, mais il ne faut pas confondre cela avec la RÃ © publique du Congo d'aujourd'hui -RRB-.	simplicity	fr
A une époque où il n'y avait qu'une poignée de joueurs noirs dans le football des collèges grand public, cela a fait de l'UCLA le club de football le plus intégré.	C'est ce qui a fait de l'UCLA l'équipe la plus intégrée du football.	simplicity	fr
R. L. Burnside -LRB- 23 novembre 1926 -- 1er septembre 2005 -RRB-, né Robert Lee Burnside, était un chanteur de blues, un auteur-compositeur et un guitariste du nord du Mississippi qui a vécu une grande partie de sa vie à Holly Springs, au Mississippi, et dans les environs.	R. L. Burnside -LRB- né Robert Lee Burnside, 23 novembre 1926 - 1er septembre 2005 -RRB- était un chanteur de blues, un auteur-compositeur et un guitariste qui vivait à Holly Springs, au Mississippi.	simplicity	fr
Il est prouvé que les tribus germaniques, y compris les Goths et les Vandales, ont brièvement pris le contrôle des îles avant que les Byzantins ne lancent une contre-attaque et ne reprennent Malte.	En 1798, Napoléon prit le contrôle de Malte.	simplicity	fr
"Prix Nobel En 1982, García Márquez a reçu le prix Nobel de littérature """" pour ses romans et ses nouvelles, dans lesquels le fantastique et le réaliste sont combinés dans un monde riche d'imagination, reflétant la vie et les conflits d'un continent ""."	"Prix Nobel En 1982, il a reçu le prix Nobel de littérature """" pour ses romans et ses nouvelles, dans lesquels le fantastique et le réaliste sont combinés dans un monde riche d'imagination, reflétant la vie et les conflits d'un continent ""."	simplicity	fr
Good Girl Gone Bad est le troisième album studio du chanteur de Barbadian R & B Rihanna, sorti le 30 mai 2007, sur Def Jam Recordings.	"""'Good Girl Gone Bad' '- 3 : 35"	simplicity	fr
Soucieux de nourrir leurs coéquipiers affamés, Ian et Tom ont tué un serpent et ont tenté d'utiliser leur sang comme appât pour les requins, mais ont échoué.	Ian et tom ont essayé de nourrir leurs tribates affamées en tuant un serpent et en essayant d'utiliser son sang pour leurrer les requins, mais ont échoué.	simplicity	fr
Typiquement, les taxons étroitement apparentés diffèrent beaucoup moins que les taxons plus distants, mais il y a des exceptions à cela.	Typiquement, les taxons étroitement apparentés diffèrent beaucoup moins que les taxons plus distants, mais il y a des exceptions à cela.	simplicity	fr
Bayel est une commune du département d'Aube dans le centre-nord de la France.	Bayel est une commune du département d'Aube dans le centre-nord de la France.	simplicity	fr
Ses passe-temps incluent jouer au piano et aussi jouer avec ses chats lorsqu'il ne fait pas d'expériences.	Ses passe-temps incluent jouer au piano et jouer avec ses chats.	simplicity	fr
L'encyclopédie.	Un doute quant à savoir si quelque chose peut être connu de certains.	simplicity	fr
Cet aigle de mer a deux sous-espèces connues et forme une paire d'espèces avec l'Aigle à queue blanche.	Le Pygargue à tête blanche est une sorte d'aigle de mer -LRB- il est parfois appelé par ce nom -RRB-.	simplicity	fr
La géographie de l'environnement combine la géographie physique et humaine et examine les interactions entre l'environnement et les humains.	La géographie physique étudie l'environnement naturel et la géographie humaine étudie l'environnement humain.	simplicity	fr
BÃ darrides est une commune du département de Vaucluse dans la région Provence-Alpes-C Ã te d'Azur dans le sud-est de la France.	BÃ darrides est une commune de 5110 habitants -LRB- 1999 -RRB-. Elle est située dans la région Provence-Alpes-C Ã te d'Azur dans le département de Vaucluse dans le sud de la France.	simplicity	fr
La banane est le nom commun d'un type de fruit ainsi que des plantes herbacées du genre Musa qui produisent ce fruit couramment mangé.	La banane est le nom commun d'un type de fruit et aussi le nom des plantes herbacées qui cultivent ce fruit.	simplicity	fr
En statistique, une allégation de confiance à 95 % signifie simplement que le chercheur a vu quelque chose se produire qui se produit seulement une fois dans 20 ou moins.	En statistique, une allégation de confiance à 95 % signifie simplement que le chercheur a vu quelque chose se produire qui ne se produit qu'une fois sur vingt ou moins.	simplicity	fr
Une grande partie du parc est classée comme réserve intégrale, où les véhicules ne peuvent pas se rendre.	Le chemin McKillops est la limite nord du parc, avec le parc national alpin au nord de la route.	simplicity	fr
Azeglio Vicini -LRB- né le 20 mars 1933 à Cesena -RRB- est un entraîneur de football italien.	Azeglio Vicini -LRB- né le 20 mars, 1933 -RRB- est un ancien joueur de football italien.	simplicity	fr
14 Irene a été découverte par J. R. Hind le 19 mai 1851 et nommée d'après Eirene, personnification de la paix dans la mythologie grecque.	Elle était l'une des Horae, fille de Zeus et de Themis.	simplicity	fr
Sa progéniture, Huitzilopochtli, a appris l'existence de ce plan alors qu'il était encore dans le ventre, et avant qu'il ne soit mis en œuvre, il naît du ventre de sa mère, complètement cultivé et entièrement armé, puis il tue sa sœur Coyolxauhqui et plusieurs de ses 400 frères.	Sa progéniture, Huitzilopochtli, a appris l'existence de ce plan alors qu'il était encore dans le ventre, et avant qu'il ne soit mis en œuvre, il naît du ventre de sa mère, entièrement cultivé et entièrement armé, et tue sa sœur Coyolxauhqui, ainsi que plusieurs de ses 400 frères et sœurs.	simplicity	fr
Au-dessus de l'écu se trouve la devise 'Dirigo' -LRB- I lead -RRB- et une étoile du Nord stylisée.	"De chaque côté de l ""écu, un fermier repose sur son scythe, et un marin se penche sur une ancre."	simplicity	fr
Blankenberge est une ville et une municipalité de la province belge de Flandre occidentale.	Blankenberge est une commune située dans la province belge de Flandre occidentale.	simplicity	fr
Les Quatre Livres de l' architecture sont édités en 1570 à Venise et comportent les gravures sur bois réalisées sous la direction de Palladio .	Les Quatre Livres de l' architecture sont eux aussi publiés à Venise en 1570 , avec des gravures sur bois réalisées sous la direction de Palladio .	simplicity	fr
En 1868, une autre partie du territoire ouest de l'Utah, dont la population cherchait à éviter la dominance mormone, a été ajoutée au Nevada dans l'est de l'État, établissant la frontière orientale actuelle.	"La partie est du Nevada faisait partie du ""territoire de l'Utah"" et la partie sud faisait partie du ""Nouveau Mexique""."	simplicity	fr
Cette liste comprend les personnes dont la mort a fait partie de l'Holocauste ainsi que les personnes qui sont mortes d'une autre manière aux mains des nazis pendant la Seconde Guerre mondiale.	Cette liste comprend les personnes dont la mort a fait partie de l'Holocauste ainsi que les personnes qui sont mortes d'une autre manière aux mains des nazis pendant la Seconde Guerre mondiale.	simplicity	fr
Laa-Laa -LRB- joué par Nikky Smedley -RRB- est le troisième Teletubby.	Laa-Laa est le troisième Teletubby.	simplicity	fr
Quick-scat fonctionne sur une orbite héliosynchrone -LRB- orbite basse-terrestre -RRB-.	C'est dans une orbite de basse terre synchronisée par le soleil.	simplicity	fr
Sa mère, Jewel Caroline Cobb -LRB- nom de jeune fille : Hoover -RRB-, a servi un mandat en tant que membre du conseil tribal.	Sa mère a exercé un mandat de membre du conseil tribal.	simplicity	fr
Il est situé à proximité des villes de Lille et Roubaix et de la frontière belge.	Biella (Italie)	simplicity	fr
Il est le cousin d'Achille, le guerrier grec le plus célèbre, et il est le demi-frère aîné de Teucer.	Il était le cousin d'Achille.	simplicity	fr
La cathédrale de Worcester a sans doute été épargnée par Henry VIII lors de la Réforme anglaise à cause de la chancellerie de son frère dans la cathédrale.	La cathédrale de Worcester n'a pas été détruite par Henri VIII pendant la Réforme anglaise à cause de la chancellerie de son frère dans la cathédrale.	simplicity	fr
"Ils ont été expulsés du Queensland à titre de punition ; le fait d'être ""perturbateur"", de tomber enceinte à un homme blanc ou d'être né avec du ""sang mixte"" ont été inclus dans les infractions qui pourraient entraîner la peine d'être envoyé à l'île de Palm."	"Pendant une grande partie du XXe siècle, le gouvernement du Queensland s'en est servi comme d'une ville pour les Aborigènes considérés comme coupables de crimes dits ""perturbateurs"", de grossesse à un homme blanc ou de naissance avec ""sang mixte""."	simplicity	fr
La théorie de l'oasis, proposée à l'origine par Raphaël Pumpelly en 1908, popularisée par Vere Gordon Childe en 1928 et résumée dans le livre de Childe, Man Makes Himself.	Elle a été proposée en 1948.	simplicity	fr
SeaMonkey se compose d'un navigateur web -LRB- SeaMonkey Navigator -RRB-, qui est un descendant de la famille Netscape, un programme de courriel et de nouvelles -LRB- SeaMonkey Mail & Newsgroups, qui partage le code avec Mozilla Thunderbird -RRB-, un éditeur HTML -LRB- SeaMonkey Composer -RRB- et un client IRC -LRB- ChatZilla -RRB-.	Il est très utile et comprend un client de messagerie électronique, un calendrier, un éditeur HTML, un client IRC et un navigateur web, il est fait par le Conseil SeaMonkey, anciennement de la Fondation Mozilla.	simplicity	fr
Brooksville est une ville constituée en société dans le comté de Hernando, en Floride, aux États-Unis.	Brooksville est une ville de Floride aux États-Unis.	simplicity	fr
En 1980, dans une interview avec le magazine Playboy, John Lennon a dit, '' '	"Dans une interview de 1980 avec le magazine Playboy, John Lennon a dit, ""Oh !"	simplicity	fr
Bien que cette définition englobe plusieurs échelles et modes comme le mode Dorien et le mode Phrygien, le terme dans son sens le plus strict est généralement limité au mineur naturel, au mineur harmonique et aux échelles mélodiques mineures, décrites ci-dessous, qui sont les plus couramment utilisées dans la musique classique occidentale - LRB- voir majeure et mineure -RRB-.	Mode musical	simplicity	fr
Champ électromagnétique - champ composé du champ électrique et du champ magnétique.	Le champ électrique et le champ magnétique sont des composantes du champ électromagnétique.	simplicity	fr
Un fort cisaillement vertical du vent dans la troposphère inhibe aussi le développement des cyclones tropicaux, mais aide à organiser les orages individuels dans des cycles de vie plus longs qui peuvent alors produire du temps violent.	Effets sur les orages et les phénomènes météorologiques violents	simplicity	fr
Les historiens parlent souvent de la période qui va de la dynastie Qin à la fin de la dynastie Qing comme la Chine impériale.	La dynastie Qin a été une dynastie très importante dans l'histoire de la Chine.	simplicity	fr
Blizzard of Ozz est le premier album studio du chanteur / parolier britannique Ozzy Osbourne, enregistré à Surrey au Royaume-Uni et sorti le 20 septembre 1980 au Royaume-Uni et le 27 mars 1981 au Blizzard of Ozz des États-Unis a été un succès commercial et a été certifié 4x Platinum aux États-Unis, -LRB- un exploit Osbourne atteindrait à nouveau avec la sortie de No More Tears -RRB-.	L'album a atteint # 21 sur le Billboards Pop Albums chart, et est sur la liste des 100 albums les plus vendus des années 1980.	simplicity	fr
L'arrondissement de LargentiÃ re est un arrondissement de France, situÃ © dans le département de l'ArdÃ © che, dans la rÃ © gion RhÃ ne-Alpes.	L'arrondissement de LargentiÃ re est un arrondissement de France qui se trouve dans le département ArdÃ che.	simplicity	fr
Il fait partie de l'aire de répartition de la rivière connue sous le nom de hautes-terres hudsoniennes.	Il fait partie de la chaîne de montagnes connue sous le nom de hautes-terres d'Hudson.	simplicity	fr
"Il tire son nom du dieu grec Phobos -LRB- qui signifie ""peur"" -RRB-, un fils d'Ares -LRB- Mars -RRB-."	Il porte le nom du dieu Phobos dans la mythologie grecque.	simplicity	fr
Elsmere est une ville du comté de Kenton, au Kentucky, aux États-Unis.	Elsmere est une ville du Kentucky aux États-Unis.	simplicity	fr
Le musée ViÄ 1 \ / 4 Ä ni raconte l'histoire de ViÄ 1 \ / 4 Ä ni des temps anciens à aujourd'hui.	ViÄ 1 \ / 4 Ä ni est une ville de Lettonie avec des droits de ville depuis 1928.	simplicity	fr
Lenzburg -LRB- district -RRB-, un district du Canton d'Aargau, dont Lenzburg est la capitale	Schloss Lenzburg, un château au-dessus de la ville de Lenzburg	simplicity	fr
Après l'atterrissage, l'engin spatial non habité Mars Pathfinder a été rebaptisé la station commémorative Carl Sagan le 5 juillet 1997.	Le site d'atterrissage de l'engin spatial non habité Mars Pathfinder a été rebaptisé la station commémorative Carl Sagan en l'honneur de M. Sagan le 5 juillet 1997.	simplicity	fr
Il est de couleur pâle avec une légère teinte grisâtre sous une croûte de moisissure blanche ; très douce et savoureuse avec un soupçon d'ammoniac.	Les autres langues françaises sont :	simplicity	fr
John Churchill, 1er duc de Marlborough, prince de Mindelheim, KG, PC -LRB- 26 mai 1650 -- 16 juin 1722 -RRB- -LRB- O. S -RRB-, était un soldat et un homme d'État anglais dont la carrière s'étendait sur les règnes de cinq monarques à la fin du XVIIe siècle et au début du XVIIIe siècle.	Marlborough.	simplicity	fr
La photographie sans autorisation préalable était également interdite dans toutes les stations MRT depuis les attentats de Madrid, mais elle ne figurait pas dans la déclaration officielle dans les examens de la sécurité des transports publics.	La photographie sans autorisation préalable a également été interdite dans toutes les stations MRT depuis.	simplicity	fr
1794 & ndash ; Traite d'un traître pendant le règne de la terreur par les révolutionnaires, le chimiste français Antoine Lavoisier, qui était aussi un percepteur de la taxe avec la Ferme Générale, est jugé, condamné et culpabilisé le même jour à Paris.	1794 - Antoine Lavoisier, chimiste français -LRB- exécuté -RRB- -LRB- b. 1743 -RRB-	simplicity	fr
