positive	negative	style_type	language
Mittelalterliche Bildquellen zeigen sowohl glattrasierte Kleriker als auch solche mit Vollbärten.	Auf mittelalterlichen Bildern sieht man Geistliche mit und ohne Vollbart. 	simplicity	German
Premierminister David Lloyd George honorierte diesen wichtigen Beitrag, indem er 1917 mit den Premierministern der Dominions das Reichskriegskabinett (Imperial War Cabinet) bildete, um die gemeinsamen Anstrengungen zu koordinieren.	Premierminister David Lloyd George belohnte diesen wichtigen Beitrag. Er gründete 1917 zusammen mit den Premierministern der Dominions das Reichskriegskabinett. Dort wurden die gemeinsamen Bemühungen koordiniert.	simplicity	German
Verschiedene Effekte sorgen jedoch dafür, dass mit steigenden Temperaturen und wachsendem atmosphärischem CO2-Anteil die Aufnahmefähigkeit der Meere für Kohlenstoff abnimmt.	Bei steigender Temperaturen und steigendem Co2-Anteil in der Athmosphäre nimmt die Aufnahmefähigkeit der Meere für CO2 jedoch ab. 	simplicity	German
Laut dem vom Arktischen Rat in Auftrag gegebenen Arctic Climate Impact Assessment wird in zahlreichen polaren Gebieten die Artenvielfalt zunehmen, weil im Zuge der Erwärmung neue Arten in die Arktis einwandern werden und die Gesamtzahl der Arten und deren Produktivität zunehmen wird.	Laut dem Arctic Climate Impact Assessment, das vom Arktischen Rat in Auftrag gegebenen wurde, wird in zahlreichen polaren Gebieten die Artenvielfalt zunehmen. Grund hier ist, dass im Zuge der Erwärmung neue Arten in die Arktis einwandern werden und die Gesamtzahl der Arten und deren Produktivität zunehmen wird.	simplicity	German
Bei der Wiedergabe wird die Abtastspitze eines Tonabnehmers entsprechend ausgelenkt.	Die Abtastspitze des Tonabnehmers wird durch die Rille geführt und bewegt sich hin und her.	simplicity	German
Bei einem Klimawandel können sich sowohl Lufttemperaturen als auch der Niederschlag in Form von Schnee verändern und damit die Massenbilanz verschieben.	Bei einem Klimawandel können sich die Temperatur der Luft und der Niederschlag verändern. Damit kann sich der Unterschied zwischen Zufluss und Masseverlust von Gletschern verschieben.	simplicity	German
Bei den Mönchsorden regelten genaue Vorschriften die Benutzung und Verwahrung der verwendeten Rasiermesser.	Bei den Mönchsorden gab es genaue Vorschriften. So wurde genau geregelt, wie Rasiermesser benutzt und verwahrt werden sollten.	simplicity	German
Teile davon wurden über geologische Zeiträume durch Druck späterer Schichten zu Metamorphen Gesteinen wie Quarzit, Tonschiefer sowie kristallinem Kalkstein (Marmor) und Dolomit umgewandelt.	Teile davon wurden über lange Zeit durch den Druck späterer Schichten zu Gesteinen umgewandelt. Diese Gesteine sind zum Beispiel Quarzit, Tonschiefer, kristalliner Kalkstein (Marmor) und Dolomit.	simplicity	German
Als Gründe dafür, dass Väter ihre Arbeitszeit relativ selten für die Familienarbeit reduzieren, werden u. a. finanzielle Nachteile aufgrund von Gehaltsunterschieden zwischen Männern und Frauen, fehlende Teilzeitstellen für höhere Positionen sowie eine Profitorientierung der Konzerne, die auf familiäre Bedürfnisse der Angestellten keine Rücksicht nehme, genannt.	"Väter reduzieren ihre Arbeitszeit relativ selten für die Familienarbeit. Das kann verschiedene Gründe haben. _x000D_
- Sie fürchten finanzielle Nachteile aufgrund von Gehaltsunterschieden zwischen Männern und Frauen_x000D_
- es gibt keine Teilzeitstellen für höhere Positionen_x000D_
- Konzerne nehmen auf familiäre Bedürfnisse der Angestellten keine Rücksicht, da sie profitorientiert organisiert sind"	simplicity	German
Der Fahrer hält das System Fahrrad/Fahrer mit kleinen Lenkausschlägen im Gleichgewicht.	Der Fahrer hält sich mit leichte Lenken im Gleichgewicht.	simplicity	German
Im Hauptfach Soziologie wurde er von Walter P. Chivers in die Problematik der Rassentrennung eingeführt; bei George D. Kelsey, dem Leiter der „School of Religion“, hörte er von Mahatma Gandhis gewaltfreiem Widerstand.	"Sein Hauptfach war Soziologie. In die Problematik der Rassentrennuung führte ihn Walter C. Chievers ein. Bei dem Leiter der ""School of Religion"" George D. Kelsey hörte er von Mahatma Gandhis gewaltfreiem Widerstand."	simplicity	German
Der erste namentlich nachgewiesene Vorfahre Albert Einsteins, ein aus dem Bodenseeraum stammender Pferde- und Tuchhändler namens Baruch Moses Ainstein, wurde im 17. Jahrhundert in die Gemeinde aufgenommen.	Der erste Vorfahre von Albert Einstein wurde im 17. Jahrhundert in die Gemeinde aufgenommen. Er hieß Baruch Moses Ainstein und war ein Pferde- und Tuchhändler. Er stammte aus dem Boodenseeraum.	simplicity	German
Teilweise vertreten verschiedene gesellschaftliche Gruppen jeweils den Standpunkt der Wahlfreiheit, allerdings mit unterschiedlicher Gewichtung: Die eine Seite hebt die Möglichkeit zur Erwerbsarbeit auch mit Kindern hervor, die andere betont die Freiheit, auch die traditionelle Familienform zu wählen.	Verschiedene gesellschaftliche Gruppen sind für die Wahlfreiheit. Allerdings möchte die eine Gruppe, dass es auch möglich ist zu arbeiten, wenn man Kinder hat. Und die andere Gruppe findet es wichtig, dass man auch traditionelle Familienformen wählen kann. 	simplicity	German
In den Tieflagen liegen Zungenbeckenseen, im höheren Gelände handelt es sich um Karseen.	In den Tälern liegen Seen, die man Zungenbeckenseen nennt. In den höheren Gegenden sind Seen, die man Karseen nennt.	simplicity	German
In der Schule war er ein aufgeweckter, bisweilen gar aufrührerischer Schüler.	In der Schule war er ein aufgeweckter Schüler. Manchmal war er etwas frech.	simplicity	German
In den folgenden Monaten entwickelte Berliner in Zusammenarbeit mit dem Techniker Werner Suess sein Verfahren weiter, indem er das rußbeschichtete Glas durch eine mit Wachs überzogene Zink- oder Kupferplatte ersetzte.	In den folgenden Monaten entwickelte Berliner gemeinsam mit dem Techniker Werner Suess sein Verfahren weiter. Das mit Ruß beschichtete Glas wurde ersetzt durch eine mit Wachs überzogene Platte aus Zink oder Kupfer.	simplicity	German
Ein Spielwürfel, umgangssprachlich einfach (wie auch ursprünglich) Würfel (von althochdeutsch wurfil: verwandt mit Wurf und werfen[1]), ist ein Gegenstand, der nach einem Wurf auf einer waagerechten Ebene eine von mehreren unterscheidbaren stabilen Ruhelagen einnimmt und in vielen Spielen zum Erzeugen eines zufälligen Symbols (oft einer Zufallszahl) dient.	Ein Spielwürfel ist ein Gegenstand, der nach einem Wurf auf einer geraden Fläche in einer von mehreren Positionen liegen bleibt. Spielwürfel (oder auch Würfel) werden in vielen Spielen benutzt, um ein zufälliges Symbol oder eine Zahl zu erhalten.	simplicity	German
Zuverlässige und instrumentell ermittelte Temperatur- und Klimadaten stehen auf breiterer Basis erst seit der zweiten Hälfte des 19. Jahrhunderts zur Verfügung.	Gemessene Temperatur- und Klimadaten gibt es erst seit der zweiten Hälfte des 19. Jahrhunderts.	simplicity	German
Die mit Abstand meistverbreiteten Spielwürfel sind jene mit den Ziffern 1 bis 6 oder entsprechend vielen Punkten, den Augen, beschriftete Kuben oder Hexaeder.	Die meisten Spielwürfel haben Ziffern (1 bis 6) oder entsprechend viele Punkte, auch Augen genannt. Die Ziffern oder Punkte befinden sich auf einem normalen Würfel (Kubus) oder einem sechsflächigen Würfel (Hexaeder).	simplicity	German
Bald danach – zum 1. Januar 1995 – traten mit Österreich, Schweden und Finnland nach zügigen Beitrittsverhandlungen drei Staaten der EU bei, die bis zum Ende der Ost-West-Konfrontation durch ihre strikte Neutralitätspolitik daran gehindert waren.	Zum 1. Januar 1995 traten Österreich, Schweden und Finnland in die EU ein. Die Beitrittsverhandlungen dauerten nicht lange. Vor dem Ende der Ost-West-Konfrontation konnten sie nicht in die EU eintreten, weil ihre Politik neutral war.	simplicity	German
Diese Erwartung wird im Zusammenhang mit der hohen Scheidungsrate, den sich ändernden Regelungen zum Unterhalt und der Diskussion um eventuelle Änderungen der Witwen-/Witwerrente in verstärktem Maß auch von der Gesellschaft an sie herangetragen.	Diese Erwartung wird noch durch die Gesellschaft verstärkt, da immer mehr Ehen geschieden werden und die Regelungen zum Unterhalt geändert wurden. Außerdem erhöht sich der Erwartungsdruck durch die Diskussion um die Änderungen der Witwen-/Witwerrente.	simplicity	German
Die Schichtdicke der Seifenblase lässt sich beobachten: Spiegelt die Oberfläche in bunten Interferenzfarben, ist die Schichtdicke vergleichbar mit der Wellenlänge des Lichts.	Die Dicke der Seifenblase lässt sich beobachten: Wenn die Oberfläche in bunten Farben spiegelt, dann ist die Schicht so Dick wie die Wellenlänge des Lichts,	simplicity	German
Der Matrosenaufstand begann auf Schillig-Reede vor Wilhelmshaven, wo die deutsche Hochseeflotte in Erwartung der geplanten Seeschlacht vor Anker gegangen war.	Der Matrosenaufstand begann vor Wilhelmshaven, auf Schilling-Reede. Dort lag die deutsche Hochseeflotte vor Anker und erwartete die Geplante Seeschlacht.	simplicity	German
Um laute Aufprallgeräusche und ein Wegrollen der Würfel zu vermeiden, wird manchmal ein gepolstertes und berandetes Brett (Würfelbrett oder Würfelteller genannt) eingesetzt.	Damit die Würfel nicht laut aufprallen und wegrollen wird manchmal ein gepolstertes Brett mit Rand eingesetzt. Dieses Brett nennt man Würfelbrett oder Würfelteller.	simplicity	German
Zudem waren sie überzeugt, im Sinne der neuen Regierung zu handeln, die Friedensverhandlungen mit der Entente anstrebte.	Sie waren außerdem überzeugt im Sinne der neuen Regierung zu handeln. Diese strebte Friedensverhandlungen mit der Entente an. Das waren die Länder, die am Ersten Weltkrieg beteiligt waren.	simplicity	German
Ein bestimmtes Bauschema scheint es nicht gegeben zu haben, man findet Räume mit meist 10 bis 22 Wannen oder Sitzwannen sowohl in rechteckiger (zum Beispiel in Olympia) als auch kreisbogenförmiger Anordnung (zum Beispiel in Gortyn, Gela und Megara Hyblaea).	Es gab kein bestimmtes Bauschema. Man findet Räume mit 10-22 Wannen oder Sitzwannen. Die Wannen waren rechteckig oder kreisbogen-förmig angeordnet.	simplicity	German
Für die Meeresspiegelerhöhung werden im Wesentlichen zwei Faktoren verantwortlich gemacht: Zum einen dehnt sich das Meerwasser bei höheren Temperaturen stärker aus, zum anderen kommt es bei höheren Temperaturen zum verstärkten Abschmelzen von Gletschern (siehe unten).	Für die Erhöhung vom Meeresstand gibt es zwei Gründe: Erstens dehnt sich Meerwasser bei höheren Temperaturen aus. Zweitens schmelzen bei höheren Temperaturen Teile von Gletschern.	simplicity	German
Diese vollständige Wiederverwertung ist Basis der Subsistenzwirtschaft.	Diese vollständige Wiederverwertung ist Grundlage für eine Wirtschaft, die auf Selbstversorgung setzt (Substinenzwirtschaft).	simplicity	German
Zwischen 1895 und 1901 nahm Churchill als aktiver Soldat und Kriegsberichterstatter an fünf verschiedenen Kolonialkriegen teil, unter anderem in Kuba auf Seiten der Spanier während des dortigen Unabhängigkeitskrieges und in verschiedenen Teilen des Empire, etwa in Malakand in der Nordwestlichen Grenzprovinz Britisch-Indiens.	Zwischen 1895 und 1901 nahm Churchill als aktiver Soldat und Kriegsberichterstatter an fünf verschiedenen Kolonialkriegen teil. Unter anderem kämpfte und arbeitete er in Kuba auf der Seite der Spanier während des dortigen Unabhängigkeitskrieges. Außerdem war er in verschiedenen Teilen des Empire, etwa in Malakandin der Nordwestlichen Grenzprovinz Britisch-Indiens aktiv beteiligt.	simplicity	German
Als Geschäftsmann sah auch er in der umständlichen – und damit teuren – Vervielfältigung der Walzen den entscheidenden Schwachpunkt des Phonographen und verwendete seine Zeit und Mühe vorrangig auf die Lösung dieses Problems.	Er sah auch in der schwierigen und teuren Herstellung der Walzen einen wichtigen Schwachpunkt des Phonographen. Ein Phonograph ist eine Maschine zum Abspielen von Musik von Walzen. Er verwendete seine Zeit und Mühe vor allem auf die Lösung dieses Problems.	simplicity	German
Die Klimamodelle beschreiben derzeit auf globaler Ebene die Folgen recht gut, können diese jedoch auf regionaler Ebene nur recht unsicher abschätzen.	Die Klima-Modelle beschreiben derzeit auf globaler Ebene die Folgen recht gut. Sie können die Folgen aber für einzelne Regionen nur sehr unsicher abschätzen.	simplicity	German
Demzufolge wird das Parlament gemeinsam mit dem Rat als Gesetzgeber tätig, übt gemeinsam mit ihm die Haushaltsbefugnisse aus und nimmt die politische Kontrolle wahr.	Das Europäische Parlament und der Rat sind als Gesetzgeber tätig. Gemeinsamen üben sie Haushalt-Befugnisse aus. Sie nehmen zudem die politische Kontrolle wahr.	simplicity	German
Die Veränderung der Konzentration der Klimagase und ihrer Zusammensetzung veränderte zudem den Strahlungshaushalt der Erde und brachte den Treibhauseffekt in Gang, der die Erde seitdem erwärmt.	Die Konzentration und Zusammensetzung der Klimagase veränderten den Strahlungshaushalt der Erde. Es kam zu einem Treibhauseffekt, der die Erde seitdem erwärmt.  	simplicity	German
Der Glacier-Nationalpark bezieht seinen Namen von der durch Vergletscherung während des Eiszeitalters geprägten Landschaft.	Während des Eiszeitalters prägten Gletscher die Landschaft. Auf diese Tatsache bezieht sich der Name des Glacier-Nationalparks.	simplicity	German
Dieser Temperaturgradient ist mit etwa 1 K/km viel zu klein, als dass Wärmeleitung einen wesentlichen Beitrag zum Wärmetransport leisten könnte.	Dieser Temperaturgradient ist mit etwa 1K/km sehr klein. Daher kann er keinen wesentlichen Beitrag zum Wärmetransport leisten.	simplicity	German
Dies sind geologische Wärmeanomalien, die oft mit aktivem Magmatismus einhergehen; dort sind mehrere hundert Grad heiße Fluide (Wasser/Dampf) in einer Tiefe von wenigen hundert Metern anzutreffen.	Dies sind geologische Wärmeanomalien, in denen man oft aktives Magma findet. Dort gibt es wenige hundert Meter tief sehr heißen Dampf.	simplicity	German
Um das Werfen mehrerer Würfel zu vereinfachen, Schummeln durch Trickwürfe zu vermeiden oder das Ergebnis vor anderen Spielern zu verbergen, kommen Würfelbecher (Knobelbecher genannt) zum Einsatz.	Damit man einfacher mehrere Würfel werfen kann, werden Würfelbecher (Knobelbecher) benutzt. Außerdem vermeidet man Schummeln und kann das Ergebnis vor anderen Spielern verbergen.	simplicity	German
Der zunehmende Abfluss des Gletscherwassers führt zudem zum globalen Anstieg des Meeresspiegels und bedroht damit auch nicht unmittelbar im Einflussbereich von Gletschern lebende Menschen.	Der Abfluss des Gletscherwassers nimmt zu und führt zudem zum weltweiten Anstieg des Meeresspiegels. Er bedroht damit auch Menschen, die nicht unmittelbar im Einflussbereich von Gletschern leben.	simplicity	German
Bei einigen Formen kann man versuchen, dies durch die richtige Wahl der Größenverhältnisse auszugleichen, etwa durch Streckung der Seitenflächen beim nebenstehenden Prisma als siebenseitiger Würfel.	Bei manchen Formen kann man versuchen die Wahrscheinlichkeit, dass eine Form auf einer Fläche landet auszugleichen. Zum Beispiel indem man eine Seitenfläche verlängert.	simplicity	German
Die Abspaltung der Dreizehn Kolonien nach dem Amerikanischen Unabhängigkeitskrieg (1775–1783) bedeutete zwar den Verlust der bevölkerungsreichsten Überseegebiete, doch wandte sich Großbritannien bald Afrika, Asien und Ozeanien zu.	"Mit der Abspaltung der 13 Kolonien hatte Großbritannien nach dem Amerikanischen Unabhängigkeitskrieg seine bevölkerungsreichsten Überseegebiete verloren._x000D_
Dafür wandte es sich nun Afrika, Asien und Ozeanien zu."	simplicity	German
Dabei spielt die Entfernung des Lenkers zum Gesäß des Radfahrers genauso eine wichtige Rolle wie die Lenkerform (Biegung) und die Höhe des Lenkers, der optimalerweise in gleicher Höhe wie die Mitte der Beckenknochen sein sollte.	Wichtig ist der Abstand zwischen Lenker und Gesäß, die richtige Lenkerform (Biegung) und dass die Höhe des Lenkers richtig eingestellt ist. Am besten sollte der Lenker genau auf der Höhe der Mitte der Beckenknochen sein.	simplicity	German
Erst bei Ausbruch des Zweiten Weltkriegs 1939 kehrte Churchill, der als erklärter Gegner Hitlers bekannt war, in die Regierung zurück, zunächst erneut als Erster Lord der Admiralität.	Als 1939 der zweite Weltkrieg ausbrach, wurde Winston Churchill wieder Mitglied der Regierung. Er war als Gegner von Hitler bekannt. Seine neue Position war die des Ersten Lords der Admiralität.	simplicity	German
Diese Abwertung wird auch als Downcycling bezeichnet, während beim Upcycling aus Abfallstoffen eines Prozesses hochwertigere Produkte hergestellt werden können. 	Man nennt das auch Downcycling. Beim so genannten Upcycling werden aus Abfallstoffen eines Produktes bessere Produkte hergestellt.	simplicity	German
Eine Retraditionalisierung der Rollen findet Studien zufolge oft nach der Geburt des ersten Kindes statt: selbst bei vorher weitgehend egalitärem Rollenverständnis beider Partner werden nach der Geburt vor allem die Auffassungen der Männer wieder traditioneller, während die der Frauen egalitär bleiben; dies führe oft zu Spannungen in der Partnerschaft.	Nach der Geburt des ersten Kindes findet meisten eine Rückkehr zur Traditionalisierung der Rollen statt. Auch wenn das Rollenverständnis beider Partner vorher auf Gleichheit gerichtet war, werden nach der Geburt die Auffassungen der Männer wieder traditioneller. Die der Frau hingehen bleiben auf Gleichheit fokussierte. So kommt es oft zu Spannungen in der Partnerschaft. 	simplicity	German
Infolge des gravitationsbedingten Auslaufens (Drainage) der zwischen den Seifenfilmoberflächen befindlichen Flüssigkeit dünnt eine Seifenblase in ihrem oberen Teil zunehmend aus.	Wegen der Erdanziehungskraft läuft die Flüssigkeit, die sich zwischen den Seifenfilmoberflächen befindet, nach unten (Drainage). Deshalb dünnt eine Seifenblase in ihrem oberen Teil zunehmend aus. 	simplicity	German
Der Berg ist der Wasserscheidepunkt an dessen Flanken sich die Einzugsgebiete des Pazifischen Ozeans, des Atlantischen Ozeans über den Golf von Mexiko und des Arktischen Ozeans über die Hudson Bay berühren.	Der Berg markiert die Grenze zwischen den Gebieten des Pazifischen Ozeans, des Atlantischen Ozean und des Arktischen Ozeans. 	simplicity	German
Abhängig von den Druck- und Temperaturbedingungen können Hochenthalpie-Lagerstätten mehr dampf- oder mehr wasserdominiert sein.	Die ebengenannten Hochenthalpie- Lagerstätten sind abhängig von Druck- und Temperaturbedingungen. Sie können mehr dampf- oder wasserdominiert sein. 	simplicity	German
Eine Seifenblase entsteht, wenn sich ein dünner Wasserfilm mit Seifenmolekülen vermischt.	Eine Seifenblase entsteht, wenn sich eine kleine Menge von Wasser (auch Wasserfilm genannt) mit einer kleinen Menge Seife mischt.	simplicity	German
Darüber hinaus sind Würfel in einer Vielzahl von Brettspielen bedeutend, um etwa die Bewegungsgeschwindigkeit von Spielfiguren oder den Ausgang von Zufallsereignissen zu bestimmen.	Außerdem sind Würfel wichtig für viele Brettspiele. Zum Beispiel um die Bewegung von Spielfiguren oder das Ergebnis von zufälligen Entscheidungen zu bestimmen.	simplicity	German
Die griechischen Sportstätten mit integrierten Bädern waren allerdings bereits zu diesem Zeitpunkt Begegnungsstätten, in denen man sich stundenlang aufhielt.	Die griechischen Sportstätten mit Bädern waren schon damals Orte in denen sich die Menschen begegneten. Außerdem hielten sich die Menschen dort viele Stunden lang auf.	simplicity	German
Sie gehören zu den frühesten Spuren vielzelliger Tiere weltweit.	Sie gehören zu den frühsten Spuren von Tieren, die aus mehreren Zellen bestehen.	simplicity	German
In vielen Familien ist es zudem ökonomisch kaum möglich, dass sich ein Elternteil ganz der Haus- und Familienarbeit widmet – für eine zunehmende Zahl von Haushalten reicht Anfang des 21. Jahrhunderts ein Erwerbseinkommen allein nicht mehr zum Unterhalt einer Familie aus.	Oft können es sich Familien finanziell kaum leisten, dass ein Elterteil nicht arbeiten geht. Seit dem 21. Jahrhundert reicht das Gehalt einer Person für eine Familie häufig nicht aus.	simplicity	German
Wortprägungen wie „weibliche Doppelverdiener“[5] wie auch der damals negativ konnotierte Begriff „Schlüsselkind“ wiesen zu dieser Zeit in Westdeutschland auf ungern gesehene Abweichungen vom Frauen- und Familienleitbild.	"Abweichungen vom Frauen- und Familienbild wurden damals in der Bundesrepublik mit negativ klingenden Begriffen wie ""weibliche Doppelverdiener"" oder ""Schlüsselkind"" kritisiert."	simplicity	German
Spannungen innerhalb der Decke führten zu einer Synklinale, einer konkav – also nach innen – gewölbten Struktur, durch die Gesteinsschichten im Osten und Westen des Parks höher liegen als im Zentrum.	Spannungen innerhalb der Decke führten zu einer konkaven - also nach innen - gewölbten Struktur. Aufgrund dieser Struktur (auch Synklinale genannt) liegen die Gesteinsschichten im Osten und Westen des Parks höher als im Zentrum. 	simplicity	German
Zwar erreichte Großbritannien nach Kriegsende 1918 durch die Übernahme deutscher Kolonien seine größte Ausdehnung, doch leiteten finanzielle Probleme und zunehmende Autonomiebestrebungen das Ende seiner globalen Bedeutung ein.	Nach Kriegsende 1918 war Großbrittanien durch die Übernahme von deutschen Kolonien am größten. Aber Geld-Probleme und Forderungen nach Unabhängigkeit führten bald zum Ende der weltweiten Bedeutung.	simplicity	German
Einer 2005 erschienenen Studie der Stanford University zufolge, die einen vorindustriellen pH-Wert des oberflächennahen Meerwassers von durchschnittlich 8,25 annimmt, verringerte sich der pH-Wert durch die Aufnahme von Kohlenstoffdioxid auf den damaligen Wert von durchschnittlich 8,14.	Laut einer Studie der Stanford University von 2005 verringert sich der pH-Wert durch die Aufnahme von Kohlenstoffdioxid auf durchschnittlich 8,14. Die Studie nahm an, dass der pH-Wert des oberflächlichen Meerwassers vor der Industrialisierung 8,25 war.	simplicity	German
Kohl war es, der Mitte 1988 Jacques Delors für die Projektleitung vorgeschlagen hatte; dieser wiederum hatte die Mitwirkung der Chefs der europäischen Zentralbanken an der Entwicklung entsprechender Pläne durchgesetzt, um den geballten Sachverstand der je obersten Währungshüter gegen zu erwartende Widerstände einzelner Regierungen ins Feld führen zu können.	Im Jahr 1988 schlug der deutsche Bundeskanzler Helmut Kohl den Franzosen Jaques Delors für die Projektleitung vor. Delors erreichte, dass sich die Chefs der europäischen Zentralbanken an der Planung beteiligten. Weil er mit dem Widerstand einzelner Regierungen gegen die geplante Union rechnete, wollte er die Unterstützung wichtiger Finanzexperten haben.	simplicity	German
Dabei ritt er in der Schlacht von Omdurman eine der letzten großen Kavallerieattacken der britischen Militärgeschichte mit.	Er ritt in der Schlacht von Omdurman mit. Das war einer der letzten großen Angriffe von Soldaten auf Pferden in der britischen Militärgeschichte.	simplicity	German
Diese finden sich beispielsweise in Grabenbrüchen (in Deutschland der Oberrheingraben) oder in tiefen Sedimentbecken.	Duckgradienten wachsen in Grabenbrüchen. Das sind Spalten oder Risse in der Erdoberfläche. Auch wachsen Duckgradienten in tiefen sandähnlichen Regionen. In Deutschland wachsen Duckgradienten zum Beispiel im Oberrheingraben. 	simplicity	German
Werden keine Maßnahmen zur Bekämpfung des Klimawandels getroffen, sind weltweit 16 % aller Arten vom Aussterben bedroht, wie eine 2015 in Science erschienene Übersichtsarbeit ergab.	Ohne  Maßnahmen zur Bekämpfung des Klimawandels sind weltweit 16 % aller Arten vom Aussterben bedroht. Dies ergab eine 2015 in Science erschienene Übersichtsarbeit. 	simplicity	German
Dezember 2009 besitzt das Europäische Parlament im Bereich der Gemeinsamen Handelspolitik das Recht, Abänderungsvorschläge zu Gesetzesentwürfen einzubringen sowie auf Ablehnung des jeweiligen Rechtsaktes.	Seit dem 1.Dezember 2009 besitzt das Europäische Parlament in der gemeinsamen Handels-Politik das Recht, Vorschläge zur Änderung von Gesetzesentwürfen einzubringen. Außerdem kann das Parlament den jeweiligen Rechtsakt ablehnen.	simplicity	German
Dabei können die Ergebnisse addiert werden (eine Waffe in einem Rollenspiel richtet soviel Schaden an, wie zwei Würfel zusammen anzeigen) oder als Ensemble betrachtet werden (bei vielen Brettspielen folgen besondere Aktionen, wenn mehrere Würfel die gleiche Zahl zeigen, bei einem sogenannten Pasch).	Dabei können Ergebnisse addiert oder zusammengehörendend betrachtet werden. Eine Waffe richtet dabei in einem Rollenspiel soviel Schaden an, wie zwei Würfel zusammen anzeigen. Wenn mehrere Würfel die gleiche Zahl anzeigen (sogenannter Pasch) folgen bei vielen Brettspielen besondere Aktionen. 	simplicity	German
Generell gilt Fahrradfahren als sehr gesund (Herz- und Kreislauftraining)[3] und gelenkschonend.	Fahrradfahren gilt als sehr Gesund für das Herz und den Kreislauf. Außerdem schont es die Gelenke.	simplicity	German
Würden die Meere kein Kohlendioxid lösen, läge die atmosphärische Konzentration von Kohlenstoffdioxid einer Untersuchung aus dem Jahre 2004 zufolge um 55 ppm höher, zum damaligen Zeitpunkt also statt bei 380 ppm bei wenigstens 435 ppm.	Wenn die Meere kein Kohlendioxid aufnehmen würden, läge die Konzentration von Kohlenstoffdioxid in der Atmosphäre deutlich höher. Eine Untersuchungs aus dem Jahr 2004 zeigte, dass sie dann statt bei 380 ppm bei 435 ppm läge. 	simplicity	German
Gleichfalls problematisch wird ein falscher Beckenwinkel auf dem Sattel für den gesamten Beckenbereich, da dieser Bereich stark mit Blut- und Nervenbahnen durchzogen ist, die auf der Innenseite der Oberschenkel liegen und die die unteren Gliedmaße zu versorgen haben.	Genauso problematisch ist ein falscher Winkel von dem Becken auf dem Sattel für den gesamten Beckenbereich.  Dieser Bereich ist stark mit Blut- und Nervenbahnen durchzogen. Diese liegen auf der Innenseite der Oberschenkel und versorgen die unteren Gliedmaßen.	simplicity	German
Im Juli 1889 kam Berliner aufgrund materialkundlicher Versuche zu dem Schluss, dass vulkanisiertes Hartgummi als Pressmaterial die günstigsten Eigenschaften aufweise, und erachtete seine Erfindung für ausgereift genug, um den Beginn der Serienproduktion einzuleiten.	Im Juli 1889 kam Berliner durch Versuche mit unterschiedlichem Material zu dem Schluss, dass vulkanisiertes Hartgummi als Material zum Pressen am besten geeignet war. Er fand seine Erfindung gut genug um mit der Serien-Produktion zu beginnen.	simplicity	German
Um Durchschnittswerte für Meereswasser angeben zu können, müssen darüber hinaus Modelle angewendet werden, um ein chemisches Gleichgewicht des Ozeans zu simulieren.	Es müssen Modelle angewendet werden, die ein chemisches Gleichgewicht des Ozeans simulieren. Damit können dann Durchschnittswerte für Meerwasser angegeben werden. 	simplicity	German
Neben dem ordentlichen Gesetzgebungsverfahren gibt es noch andere Formen der Rechtsetzung in der EU, bei denen das Parlament weniger Mitspracherechte besitzt.	Auch bei anderen Arten der Gesetzgebung hat das Parlament weniger Mitspracherechte. 	simplicity	German
Eine Balance zwischen verschiedenen Lebensbereichen zu ermöglichen, gilt als eine wichtige gesellschaftspolitische Herausforderung, als ein betrieblich relevantes Thema bezüglich Wirtschaftlichkeit und Organisationskultur sowie als ein sozial, kulturell und pädagogisch bedeutsames Thema bezüglich der Gestaltung von Familienkultur.	Eine Balance zwischen verschiedenen Lebensbereichen zu ermöglichen gilt als eine wichtige gesellschaftspolitische Herausforderung. Diese Balance ist wichtig für Wirtschaftlichkeit und Organisationskultur. Aber auch für die Gestaltung der Familienkultur ist sie ein sozial, kulturell und pädagogisch bedeutsames Thema. 	simplicity	German
So schildert der achte Gesang beispielsweise, wie im Hause des Phaiakenkönigs Alkinoos Odysseus von den Haussklaven ein Bad zubereitet wird, bevor er sich an der Tafel seines Gastgebers niederlässt.	So schildert der achte Besang beispielsweise folgende Szene:  Im Hause des Phaiakenkönigs Alkinoos wird für Odysseus ein Bad zubereitet. Danach lässt er sich an der Tafel seines Gastgebers nieder. 	simplicity	German
Am 20. September 1944 begann King sein Studium am Morehouse College, der einzigen Hochschule für Schwarze im Süden; es nahm ihn trotz seines Alters von noch nicht 16 Jahren als Ausnahme auf.	Am 20. September 1944 begann King sein Studium am Morehouse College. Das war die einzige Hochschule im Süden, die auch Schwarze aufnahm. Obwohl King noch nicht mal 16 Jahre alt war, wurde er hier aufgenommen. 	simplicity	German
Der Bauplan ist genau dann ideal, wenn die Ruhepositionen des Würfels aufgrund seiner Symmetrie erst durch eine Beschriftung unterscheidbar werden.	Ein Würfel ist dann gut, wenn er von allen Seiten gleich aussieht. Nur die Beschriftung soll sich unterscheiden.	simplicity	German
Sie kann sowohl direkt genutzt werden, etwa zum Heizen und Kühlen im Wärmemarkt (Wärmepumpenheizung), als auch zur Erzeugung von elektrischem Strom oder in einer Kraft-Wärme-Kopplung.	Die Wärme kann direkt genutzt werden. Zum Beispiel zum Heizen oder Kühlen (mit Wärmepumpheizungen). Sie kann auch genutzt werden um Strom zu erzeugen.	simplicity	German
Sie umfasst die in der Erde gespeicherte Energie, soweit sie entzogen und genutzt werden kann, und zählt zu den regenerativen Energien.	Erdwärme ist die in der Erde gespeicherte Energie, wenn sie entzogen und genutzt werden kann. Die Erdwärme zählt zu den erneuerbaren Energien.	simplicity	German
Deshalb ist für jede der betroffenen Regionen gesondert zu prüfen, welche Faktoren für den Rückgang der Gletscher ursächlich und gegebenenfalls dominierend sind.	Die Ursachen für den Rückgang der Gletscher müssen deshalb für jede Region einzeln geprüft werden. Dann versteht man die Größe und Relevanz der Faktoren. 	simplicity	German
Wegen seiner dunklen Färbung reduziert Kryokonit wesentlich die Oberflächenreflexion des Sonnenlichts und beschleunigt oder initiiert damit das Schmelzen der Gletscher.	Wegen seiner dunklen Färbung vermindert Kryokonit die Oberflächenreflexion des Sonnenlichts sehr stark. Deshalb kommt es zu einer noch schnelleren Abschmelze der Gletscher.	simplicity	German
Globale Erwärmung ist der beobachtete und prognostizierte Trend zu einer im Vergleich zu den vorindustriellen Werten höheren globalen Durchschnittstemperatur mit Folgen wie steigenden Meeresspiegeln, Gletscherschmelze, Verschiebung von Klimazonen, Vegetationszonen und Lebensräumen, verändertes Auftreten von Niederschlägen, stärkere oder häufigere Wetterextreme wie Überschwemmungen, Stürme und Dürren, Ausbreitung von Parasiten und tropischen Krankheiten sowie mehr Umweltflüchtlingen.	Globale Erwärmung ist der beobachtete und vorhergesagte Trend zu einer höhreren weltweiten Durschnittstemperatur als vor der Industrialisierung. Folgen sind: Steigende Meeresspiegel, Gletscherschmelze, Verschiebung von Klimazonen, Vegetationszonen und Lebensräumen, verändertes Auftreten von Niederschlägen, stärkere oder häufigere Wetterextreme wie Überschwemmungen, Stürme und Dürren, Ausbreitung von Parasiten und tropischen Krankheiten sowie mehr Umweltflüchtlingen.	simplicity	German
Entscheidend für das Fortbestehen eines Gletschers ist seine Massenbilanz, die Differenz von Akkumulation (wie Schneefall, Ablagerung von Triebschnee und Lawinen, Kondensation von atmosphärischem Wasserdampf und Anfrieren von Regenwasser) und Ablation (Schmelze, Sublimation sowie Abbruch von Lawinen).	Damit ein Gletscher weiter besteht, ist seine Massen-Bilanz wichtig. Die Massenbilanz ist der Unterschied von Zuwachs durch Schneefall und Gefrieren von Regenwasser und das Abnehmen durch Schmelze und Abbrüche.	simplicity	German
Das ist nur etwa das Doppelte des Weltenergiebedarfs, was bedeutet, dass Erdwärmenutzung im großen Stil immer auf eine lokale Abkühlung des Gesteins hinausläuft.	Das ist nur etwa das Doppelte des Energiebedarfs der Welt. Das bedeutet, dass die Benutzung von Erdwärme immer dazu führt, dass an sich diesen Stellen das Gestein abkühlt.	simplicity	German
Das autoritäre Erziehungssystem dort widerstrebte ihm, und er blieb mehrfach sitzen.	Die befehlerische Erziehung dort gefiel ihm nicht und er blieb mehrfach sitzen.	simplicity	German
Aus den Ablagerungen von Sanden, Tonen und den Kalkgehäusen von Zooplankton in einem Urmeer entstanden zunächst Gesteine wie Sandstein, Schiefer und Kalkstein.	Aus den Sand-, Ton- und Kalkablagerungen in einem ehemaligen Meer entstanden zuerst Gesteine wie Sandstein, Schiefer und Kalkstein.	simplicity	German
Vergleichbare Stellen belegen eine sorgfältige Reinigung vor Gebeten und Opfern und die Sitte, dem Gast zunächst Wasser zu reichen, damit er sich seine Hände waschen könne und ihm anschließend ein Bad anzubieten.	Es gibt Schriften, die erzählen, dass es üblich war, sich vor Gebeten und Opfern gründlich zu waschen. Außerdem gab es eine Tradition, seinem Gast Wasser zum Händewaschen zu geben und ihm anzubieten, ein Bad zu nehmen.	simplicity	German
Das Bundesverfassungsgericht spricht dem Europäischen Parlament in seinem Urteil zum Lissabon-Vertrag vom 30. Juni 2009 nur eine eingeschränkte demokratische Legitimation zu und sieht seine Entscheidungskompetenzen bezüglich weiterer Schritte einer europäischen Integration dadurch begrenzt.	Das Bundesverfassungsgericht berechtigt das Europäische Parlament in seinem Urteil zum Lissabon-Vertrag (30. Juni 2009) nur zu wenigem. Dadurch sieht das Gericht die Entscheidungsfähigkeit des Parlamentes für die europäische Integration als begrenzt.	simplicity	German
Allerdings deckt die 14C-Methode nur einen relativ schmalen zeitlichen Bereich von 300 bis maximal 57.000 Jahren ab.	Mit der 14C-Methode kann man allerdings nur einen relativ kleinen Zeitraum untersuchen. Dieser reicht von 300 bis 57.000 Jahren. 	simplicity	German
Auf den Schlachtschiffen des I. Geschwaders Thüringen und Helgoland gingen Teile der Besatzungen zu offener Meuterei und Sabotageakten über.	Auf den Schlachtschiffen des ersten Geschwaders Thüringen ging ein Teil der Besatzung dazu über sich gegen den Kapitän zu stellen und zu meutern. Darüber hinaus beschädigten sie das Schiff absichtlich und machten es für den Einsatz untauglich. Das gleiche taten Teile der Matrosen des ersten Geschwaders Helgoland.	simplicity	German
Er wurde am 11. Mai 1910 unter Schutz gestellt, wird vom National Park Service verwaltet und dient wegen seiner langen Forschungsgeschichte als Referenzgebiet für die Erforschung der Klimageschichte und der globalen Erwärmung.	Der Park wurde am 11. Mai 1910 unter Schutz gestellt und wird vom National Park Service verwaltet. Er wurde schon lange erforscht. Deshalb wird er oft als Beispiel-Gebiet für die Erforschung der Geschichte des Klimas und der globalen Erwärmung genutzt.	simplicity	German
Nach dem 2007 erschienenen Vierten Sachstandsbericht der Zwischenstaatlichen Sachverständigengruppe über Klimaänderungen (IPCC) stieg die weltweite durchschnittliche Lufttemperatur in Bodennähe zwischen 1906 und 2005 um 0,74 °C (± 0,18 °C) an.	"Nach dem vierten Bericht in 2007 stieg die weltweite durchschnittliche Lufttemperatur in Bodennähe zwischen 1906 und 2005 um 0,74 Celsius (+-0,18 C) an._x000D_
Der Bericht wurde geschrieben von der IPCC, einer Umwelt-Gruppe für Kilmaänderungen. "	simplicity	German
In Pompeji gefundene Exemplare von frühen Klapp-Rasiermessern mit 12 Zentimeter langen trapezförmigen Klingen und Griffen aus Elfenbein gehörten als Luxusobjekte zum Hausstand höherer Schichten.	In Pompeji wurden frühe Klapp-Rasiermesser gefunden. Diese hatten 12 Zentimeter lange Klingen in der Form von einem Trapez und Griffe aus Elfenbein. Sie gehörten meistens reichen Leuten und waren Luxus-Objekte.	simplicity	German
Ausgehend von Altpapier-Wiederverwendung wurden zunehmend Technologien erarbeitet, die die Wiederaufbereitung aller Arten von Altstoffen wirtschaftlich machen, wodurch Abfall zu einem bedeutenden Wirtschaftsgut wurde: Geprägt wurde dafür der Ausdruck Sekundärrohstoff.	Ausgehend von Altpapier-Wiederverwendung wurden zunehmend Technologien erarbeitet, die die Wiederaufbereitung aller Arten von Altstoffen wirtschaftlich machen. Dadurch wurde Abfall zu einem bedeutenden Wirtschaftsgut. Dafür entstand der Ausdruck Sekundärrohstoff.	simplicity	German
Erleichtert wurde der Vorgang allein in Badestuben, in denen Wasser oder Dämpfe das Barthaar vor der Verwendung des Rasiermessers erweichten.	In Badstuben wurde das Barthaar mit Wasser oder Dämpfen vor dem Rasieren erweicht. Das erleichterte die Rasur mit dem Rasiermesser.	simplicity	German
Sie wurden in einem geschlossenen Kasten aufbewahrt und von einem eigens hierfür bestimmten Bruder vor der Verwendung geschärft.	Sie wurden in einem geschlossenen Kasten aufbewahrt. Ein hierfür bestimmter Mönch schärfte sie vor der Verwendung. 	simplicity	German
Außerdem waren bereits zahlreiche Heilquellen bekannt, von denen viele Göttern geweiht waren.	Zahlreiche Heilquellen waren bekannt. Diese wurden den Göttern geweiht.	simplicity	German
Ihm gelang es 1860, das französische Kinderlied Au clair de la lune mit Hilfe eines großen Trichters einzufangen und mit einer Membran, die die Schwingungen auf eine Schweineborste übertrug, auf eine rußgeschwärzte Walze zu kratzen.	1860 gelang es ihm, ein französisches Kinderlied mit Hilfe eines großen Trichters einzufangen. Eine Membran übertrug die Schwingungen auf eine Schweineborste. So wurde das Lied auf eine rußgeschwärzte Walze gekratzt.	simplicity	German
Auch der Gesamtenergieverbrauch bei der Wiederaufbereitung wird vielfach überschätzt.	Viele überschätzen den Gesamtenergieverbrauch bei der Wiederaufbereitung.	simplicity	German
Ein eher seltenes, komplett auf Würfel als Spielmaterial setzendes Spielprinzip ist das der Sammelwürfelspiele, bei denen man analog zu Sammelkartenspielen eine Vielzahl von Würfeln käuflich erwerben und taktisch einsetzen muss.	Sammelwürfelspiele sind Spiele, die nur Würfel benutzen. Bei diesen Spielen muss man wie bei Sammelkartenspielen Würfel kaufen und taktisch einsetzen.	simplicity	German
Als zweitgrößte Belastungszone ist der Kontakt zwischen Gesäß und Sattel anzusehen.	Neben den Füßen wird beim Radfahren auch das Gesäß belastet.	simplicity	German
Zu stark gezinkte Würfel verraten sich durch eine torkelnde Rollbewegung, was beim Einsatz eines Würfelbechers aber nicht auffällt.	Gezinkte Würfel rollen unregelmäßiger. Das fällt aber nicht auf, wenn man einen Würfelbecher benutzt.	simplicity	German
Während über die Ursachen der globalen Erwärmung weitgehend Einigkeit besteht[1] (hauptsächlich menschliche Emissionen von Treibhausgasen), werden ihre Folgen intensiv erörtert.	Über die Ursachen der globalen Erwärmung ist man sich weitgehend einig. Die Ursache sind hauptsächlich durch Menschen entstandene Treibhausgase. Die Folgen der globalen Erwärmung werden aber viel diskutiert.	simplicity	German
Der Westen unterliegt dem maritimen Einfluss des Pazifischen Ozeans mit gemäßigten Temperaturen und hohen Niederschlägen, während die Ostseite dem kontinentalen Klima zugehörig ist, das durch extreme jahreszeitliche Temperaturunterschiede und die für Nordamerika typischen Blizzards aus nördlichen Richtungen geprägt ist.	Durch den Einfluss des Pazifischen Ozeans unterliegt der Westen gemässigten Temperaturen und hohen Niederschlägen. Die Ostseite ist dem Landklima zugehörig. Es ist durch sehr starke jahreszeitliche Temperaturunterschiede geprägt. Aus nördlichen Richtungen kommen schwere Schneestürme. Diese sind für Nordamerika typisch.	simplicity	German
In Deutschland werden Infrastrukturmaßnahmen in Kombination mit Änderungen der familienbezogenen Transferleistungen und der Besteuerung insbesondere als wesentlich für eine Verringerung der Kinder- und Familienarmut genannt.	Um Kinder- und Familienarmut zu verringern, wurden in Deutschland viele Strukturen verändert. Es wurden Steuern und Förderungs-Gelder verändert.	simplicity	German
