positive	negative	style_type	language
Nocoj sta se oče in mati pogovarjala, da so danes selili tiste ljudi, ki so zoper Nemce.	Mati je rekla: Selijo tiste ljudi, ki ne marajo Nemcev.	simplicity	sl
Natanko je videl, kako je imel župnik zvezane roke in kako je počasi korakal dalje s klobukom, nizko na čelo pomaknjenim.	Župnik je imel zvezane roke.	simplicity	sl
Zvečer doma ni povedal, kaj je storil tisti dan.	Doma ni povedal, kaj je storil tisti dan.	simplicity	sl
Koliko je prejokala ta mučena ženska, ve samo Mati božja, ki je štela v nočeh solze ponižne in v trdo usodo vdane moje matere.	Veliko je jokala.	simplicity	sl
V restavraciji Druga violina, ki deluje v prostorih mesta v starem mestnem jedru, so zaposlene osebe z motnjami v duševnem razvoju.	Ljudje s posebnimi potrebami lahko v Ljubljani delajo v gostilni Druga violina.	simplicity	sl
Mešati se mu je pričelo. Kri ga je zalila in umrl je na trdem ležišču prej, kot je prišel kaplan iz Poljan.	Začel je čudno govoriti, potem je umrl.	simplicity	sl
Ozrl se je najprej na punčko, ki jo je Breda držala v naročju, potem na tiste rože pri oknu. Zaklel je glasno, se pognal proti zdravniku, ga zagrabil za vrat in zvlekel skozi vrata na dvorišče. Potem je planil nazaj v kuhinjo, iztrgal Bredi punčko iz naročja in jo treščil po tleh. Videla je, kako so odletele nogice proti peči in glavica v kot, potem pa nenadoma ni videla ničesar več.	Zaklel je in vrgel zdravnika na cesto,  punčko pa raztrgal.	simplicity	sl
Nekaj razbojnikov je letalo okrog poslopja, nekaj pa tolklo na sprednja vrata ter zahtevalo, da naj Polikarp izroči svojo vojno kaso, če noče, da s silo ne vlomijo v hišo.	Nekega večera so k nam prišli razbojniki. Hoteli so očetov denar.	simplicity	sl
Le ena sama, tiha želja je neumorno živela v Vestru in ta je bila, da bi bilo že konec te vojske.	Vester si je želel, da bi bilo kmalu konec vojne.	simplicity	sl
Oče se je branil in nazadnje tudi obranil.	Oče je rekel, da nič ne ve.	simplicity	sl
Z udarci je prebudil spečega otroka ter ga pretepel, da je vedel, »kako se je kruh zastonj«.	Matevž je začel Tomažka tepsti.	simplicity	sl
Neko jutro sta Matevžek in Lida sedela na vrhu najvišjega hriba in tesno skupaj opazovala ptice. Medtem je vedno više plavajoče sonce zmeraj bolj ogrevalo oba.	Neko jutro sta Matevžek in Lida skupaj sedela na hribu. Gledala sta ptice in bilo je vroče.	simplicity	sl
"Raus e patacis, repa in krompir!"""	Repa in krompir.	simplicity	sl
Pod tem zidovjem, čisto na samem, je stala stara bajta, ki je bila še obljudena.	Pod hribom je stanovala družina.	simplicity	sl
Ker je bil prav miren, je smel bivati izven zaklenjenih, strogo ločenih bolniških prostorov. Lahko se je svobodno gibal po zavodu in pritiskal na zvonce.	Ker je bil miren človek, je lahko hodil po zavodu in pritiskal na zvonce.	simplicity	sl
"Hlapec Lukež je ostro dejal: ""Na to misli, pa bodi človek in ne živina, Polikarp!"""	Hlapec Lukež je rekel očetu: Bodi človek, ne žival!	simplicity	sl
Sluga vpraša Romea, če zna brati.	Sluga sreča Romea in ga vpraša, če zna brati.	simplicity	sl
Pokazal mi je še druge zapore, same ozke, temne luknje, v katere so metali jetnike kakor prašiče v svinjak.	Pokazal mi je ječe in prostore, kjer ljudi mučijo in ubijejo.	simplicity	sl
Sredi noči je zopet videla prikazen in grdo se ji je sanjalo.	Ponoči se ji je grdo sanjalo.	simplicity	sl
In to leto za letom!	Tako slabo je živel veliko let.	simplicity	sl
Ona pa mu je tudi sredi cerkve hladnokrvno odgovorila: “No, če bi te bila zavoljo lepote jemala, bi te tako ne bila vzela!”	Grd si brez ušesa, grd bi bil tudi z njim.	simplicity	sl
Ni me pograbila jeza, ker to, kar se je bilo zgodilo v Loki, sem bil že davno izbrisal iz svojega spomina.	Zaradi nezgode v Loki nisem bil več jezen nanj.	simplicity	sl
Govorili so, da je sin lepega cigana in domače lepotice, ki ga je skrivaj nosila in porodila ter nato odložila v obcestni jarek.	Ljudje so govorili, da je sin lepega cigana in domače lepotice. Lepotica ni nikomur povedala, da je noseča. Ko je rodila, je dojenčka pustila v jarku.	simplicity	sl
Z zgornje postaje vzpenjače na grajskem griču je z dvigalom urejen neoviran dostop do grajskega dvorišča, kjer je tipna maketa Ljubljanskega gradu s pripisi v brajici.	Pri zgornji postaji je dvigalo. Z njim se peljemo na grajsko dvorišče. Na grajskem dvorišču je maketa gradu. Napisi so tudi v brajici.	simplicity	sl
Potem jo je zgrabil za roko in za lase in jo vlačil po kuhinji iz kota v kot.	Za lase jo je vlačil po kuhinji.	simplicity	sl
"Le včasih, kadar je civilist za hip prenehal vihteti rovačo, je Vester začul kletev ali psovko. ""Ali boš kopal, bandit!"""	Na moške so kričali: Delaj, bandit!	simplicity	sl
Nenadoma se je pojavil na vratih oče. Bil je pijan.	Oče je prišel domov pijan.	simplicity	sl
Sluga pravi: mene pošiljajo, da naj najdem ljudi, ki so jim imena napisana tu na vabilih, pa še najti ne morem, katera imena je bil pisar tu napisal.	Vabila za ples mora razdeliti sluga. Sluga ne zna brati.	simplicity	sl
Oženim te. Na vse to mi je oče še razodel, da se je z Jeremijem Wulffingom že dogovoril, in sicer zaradi hčere Margarete, katero je imel iz drugega svojega zakona.	Rekel je tudi, da mi je izbral nevesto. Ime ji je Margareta in živi v sosednjem kraju. Margareta je hči Jeremije Vulfinga.	simplicity	sl
Tedaj se je Vester v hipu odločil. Vrh razvalin se je nekaj kamenja le še za silo držalo zidu. Iztegnil je roko in odrušil kup kamenja, ki se je zvalil v žrelo stolpa.	Nekaj kamenja je zvalil na dno stolpa.	simplicity	sl
"Breda je slišala, kako je zdravnik rekel materi: ""Njeno stanje se slabša. Ako oče ne bi bil tak pijanec in bi se doma razmere uredile, bi bilo morda bolje, vsaj otrok se ne bi razburjal. Tako pa je vedno težje bolna in dobiva napade."""	Zdravnik je rekel: Bredino zdravje gre na slabše. Ko se razburi, dobi napad.	simplicity	sl
Na grad sem pa le prišel! Ječar Mihól Schwaiffstrigkh je bil naročil pri našem mojstru novo kladivo.	Grad sem obiskal, ko sem ječarju nesel novo kladivo. Ječarju je bilo ime Mihol.	simplicity	sl
Julija pravi: Nocoj ga vidim in spoznala bom, če nagnjenje rodi se iz pogleda.	Julija obljubi, da si ga bo ogledala.	simplicity	sl
Po prstih so se približali župnišču, po prstih so stopili do okna in pogledali skozi reže priprtih temnic - in ostrmeli so, da jim je zaprlo sapo, zakaj soba je bila vsa zlata.	Pogledali so skozi okno.	simplicity	sl
Takoj je dostavil: »To pa nikakor ni moj posel, vse opravlja rabelj, ki ga navadno iz Ljubljane pokličejo in katerega še pogledam ne.	Mučenje opravlja rabelj.	simplicity	sl
Včasih pride učiteljica mimo vrta in se pogovarja z materjo, njo pa pogladi po licih.	Učiteljica je včasih šla mimo njihovega vrta.	simplicity	sl
In šla je mimo!	Potem je šla naprej.	simplicity	sl
"""Ali boš skočil z mosta?"""	Spraševali so ga, če bo skočil z mosta.	simplicity	sl
V ta rumeni denar sem se zagledal in polastila se me je lakomnost.	Hotela sva vedno več denarja.	simplicity	sl
Vestru, ki je prižet na vrh stolpa vse to opazoval, se je čudno zdelo, da zdaj vsi ljudje vpijejo samo nemško.	Čudno se mu je zdelo, da vsi ti ljudje govorijo drugačen jezik.	simplicity	sl
Obljubila ji je, da prinese pravljice. Res jih je prinesla. Sedla je k njej na klop in pričela listati po debeli knjigi.	Bredi je rekla, da ji bo prinesla pravljice.	simplicity	sl
Poskusiti jo je hotel na Tomažkovi koži.	Z njo je hotel tepsti Tomažka.	simplicity	sl
Oče je pričel govoriti in dolgo je govoril o sebi.	Oče mi je dolgo govoril o sebi.	simplicity	sl
Otrok se je razvijal nenavadno dobro in hitro, čeprav je z materjo vred preživel največ časa v hlevu poleg živine; z devetimi meseci je že shodil, s poldrugim letom že govoril.	Otrok je z mamo veliko časa preživel v hlevu. Hitro je začel hoditi. Hitro se je naučil govoriti.	simplicity	sl
Postala je najboljša, najskrbnejša mati in je negovala dete z največjo ljubeznijo in nežnostjo ter ga varovala kakor levinja svojega mladiča.	Terba je postala najboljša mama. Dojenčka je pazila in skrbela zanj. Pazila ga je tako, kot mama levinja pazi na svoje mladiče.	simplicity	sl
"Šele ko ga je oblila kri, se je spomnil, da mora bežati. Šele tedaj se ga je polastila razdraženost in jeza. ""Prekleta smrklja, sraka, ciganka, jaz ti bom že pokazal,"" je zakričal, zagrabil kamen in ga zagnal proti nji. Nemo se je izognila kamnu in drugemu in tretjemu in ostalim, ki so frčali proti nji."	Zbežal je in kričal: Prekleta smrklja, ciganka, sraka, jaz ti bom že pokazal. Metal ji je kamenje.	simplicity	sl
Mestna hiša, imenovana tudi Magistrat ali Rotovž, ki je bila zgrajena v poznem 15. stoletju, je sedež Mestne občine Ljubljana.	Mestni hiši rečemo tudi Magistrat ali Rotovž. V Mestni hiši je sedež Mestne občine Ljubljana. Mestna hiša je zelo stara.	simplicity	sl
"Ko so končali, se je komandant obrnil proti civilistom in jim glasno zaklical: ""Poglejte, tukaj vas bo jutri vrag vzel!"""	Tukaj vas bomo jutri ubili.	simplicity	sl
Ravno, ko smo bili z delom pri kraju, je sprožil Šved, ki je ležal ranjen pod polomljenim vozom, svoj samokres na nas ter Lukeža težko ranil.	V novem boju je bil Lukež hudo ranjen.	simplicity	sl
Takoj, ko sem ozdravel, me je oddal oče, ki morda ni rad gledal pohabljene moje roke, Ahacu Langerholzu v Škofjo Loko.	Oče me je poslal v mesto Škofja Loka.	simplicity	sl
Ali privadil sem se kraja in takrat sem opazil na nemarno skupaj nastlani postelji črn železen zaboj.	Opazil sem zaklenjen železen zaboj.	simplicity	sl
Polna divje nestrpnoti je začela razbijati po zaprtih vratih.	Udarjala je po vratih.	simplicity	sl
Zdaj je minilo že dvajset let, pa še ni izdelal takšne palice, ki bi bila na obeh koncih, okoli in okoli, čez in čez in sploh povsod enaka.	Še vedno ni naredil povsod enake palice.	simplicity	sl
»Miholica!« je zastokal, »ali si videl?« »Vidiš, Matevž«, je odgovoril oni, »kadar nečem, da bi videl, tedaj ne vidim.	Sosed je rekel, da ni nič videl.	simplicity	sl
Zagledala je radijski aparat. Tih in nem je stal pred njo. Zakaj ji je gospa prepovedala dotakniti se aparata?	V stanovanju je našla radio. Radia ni smela poslušati.	simplicity	sl
Otrok je to slišal večkrat na dan, zato ni čudno, če je iz vseh teh naglo izgovorjenih besed, ki jih še ni razumel, zanj nastala samo ena.	Fant je vsak dan slišal te besede.	simplicity	sl
Nesrečniki so se stisnili v lopo pokopališke cerkvice, da bi se v zatišju oddahnili, preden jo mahnejo čez odprta polja k Hotejcu.	Prišli so do pokopališča.	simplicity	sl
S polenčkom ji je preštel kosti — a ženska se je dala tepsti ter je prespavala dan za dnevom na peči.	Matevž jo je zaradi njene lenobe tepel.	simplicity	sl
To poročilo je bilo za njega, ošabnega, imovitega nemškega kmeta, pekoča sramota.	Za njihovo družino je bila to sramota.	simplicity	sl
"""Kje gori?"" je prestrašeno ponovil Matic Enaka Palica."	Enaka Palica je ponovil: Kje gori?	simplicity	sl
Gospodar je zakričal, kakor bi mu hoteli odsekati glavo, se zgrudil na kolena in z vzdignjenimi rokami prosil hlapca, naj se ga usmili.	Ubiti je hotel tudi gospodarja. Gospodar je prosil za svoje življenje.	simplicity	sl
In ko je Tratarjevo Rotijo, kateri so gledali krivo izpod čeljusti zobje in ki je bila najgrša ženska v devetih farah na okrog, povprašal, če ga hoče v zakon, je odgovorila zbadljivo: »Ko bi ti že bili odrezali eno nogo, ali eno roko, potem bi te vzela. Ali brez ušesa! Ne morem!«	Ni ga hotela niti najgrša ženska v vasi.	simplicity	sl
"""In zdaj se boste razšli."	Nagnal jih je iz kraja.	simplicity	sl
Že je tičalo bodalo v moji roki in sunil sem Jošta zadaj pod tilnikom v telo, da se mu je curkoma ulila kri. Nato je umrl.	Med prepirom sem Jošta zabodel z nožem in Jošt je umrl.	simplicity	sl
Cela gostilna se je pridružila Wulffingovim in kričala name.	Vsi so bili jezni.	simplicity	sl
Že na brvi pod visoškim domom sva čula vpitje jeznega očeta.	Ko sva se vrnila domov, je bil oče slabe volje.	simplicity	sl
Krstili so ga za Peregrina, ker so ga našli na dan tega svetnika, in rekli so mu Najdeni, ker je bil najdenček.	Ljudje so mu dali ime Najdeni Peregrin. Najdeni so mu rekli zato, ker so ga našli. Peregrin so mu rekli zato, ker so ga našli na dan svetega Peregrina.	simplicity	sl
Ker pa vse skupaj še ni gotovo, ne bosta jahala po poti skozi Selce, peš bosta hodila po gozdovih okrog Blegoša.	Potovala sva peš.	simplicity	sl
Pojoči kanarček je skočil nanj, peti pa ni prenehal in tudi Breda se ni nehala smejati, kar je navdajalo Matejčka z neznanskim veseljem.	Kanarček se ji je usedel na prst in zapel. Kanarček je pel, Breda se je smejala. Kanarček ni nehal peti, Breda pa se ni nehala smejati. Matejček je bil zelo vesel.	simplicity	sl
Ko so pretekli trije tedni, je prišla po Marksa sestra Margareta, ali skril se je pred njo, da ga niti videla ni.	Po Marksa je prišla sestra Margareta.	simplicity	sl
Na rebri poleg Vrbarjeve hiše pa je ležal Tomažek in same kosti so ga bile.	Tomažek je bil suh kot kost.	simplicity	sl
"Ko je pesem izzvenela in so še vsi zijali z odprtimi usti, je norček skočil z zapečka in radostno zaploskal: ""Tantantadruj, tako bodo igrali mučeniki!"""	Tantadruj je rekel: Tako bodo igrali mučeniki.	simplicity	sl
In zopet sem stal pred prodajalno v Loki ter gledal na svetlo okovani samokres, ki je bil tisti mah želja vseh mojih otroških želja.	Z denarjem bi si lahko kupil pištolo.	simplicity	sl
Mesec dni je ležala v postelji in tresel jo je mraz.	Breda je dobila vročino. 1 mesec je ležala v postelji.	simplicity	sl
Priletelo je nekaj črnega. Spodaj so tolovaji pograbili in odnesli onega, ki se je zvijal na tleh, tu pri oknu pa se je zgrudil Lukež. Ravno nad srcem mu je tičala globoko v prsih tanka puščica.	Lukeža je zadela puščica.	simplicity	sl
Ko je Lida povečerjala, se je zagledala v starčeve prijazne oči in potem mu je začela pripovedovati na dolgo in široko o svojem življenju.	Po večerji je Lida starcu pripovedovala o svojem življenju.	simplicity	sl
Navodila mi je dajal za gospodarstvo in za kupčijo z vinom; posebno če prodajam, naj se branim domačega denarja, ker je dosti manj vreden kot pa denar nemške veljave.	Dal mi je nasvete o denarju.	simplicity	sl
Nekoč sta bila tovariša spet zelo zaposlena. Na vrtu sta urejevala konjsko dirkališče.	Nekoč sta se Jakec in mož igrala na vrtu. Naredila sta dirkališče za konje.	simplicity	sl
Zdravnik je prišel poprej kot oče. Prinesel je mami rož, njej pa punčko.	Na praznovanje je prišel tudi zdravnik. Zdravnik je Bredi prinesel punčko, materi pa rože.	simplicity	sl
Postala je zelo razigrana.	Postala je zelo razigrana.	simplicity	sl
Lotil se je dela z veliko vnemo in bil prvi hlapec, kakor boljšega do tistih dni še nisem imel.	Bil je zelo priden delavec.	simplicity	sl
Slugi pravi, da ga bo spremil na ples, čeprav ga niso povabili.	Odloči se, da bo šel na ples, čeprav ni bil povabljen.	simplicity	sl
V najboljšem premišljevanju, kako si hočem kupiti ponosno orožje, je pograbila železna pest mojo roko, v kateri sem stiskal beneški denar.	Cekin sem pobral, ravno takrat pa se je oče vrnil v klet.	simplicity	sl
Ko sva stopila zopet na dvorišče, sem bil ves v potu. In tako globoko se mi je vkopalo v dušo, kar se mi je bilo razkazalo, da mi je hotelo slabo postati.	Ko mi je pokazal orodje za mučenje, mi je od groze postalo slabo.	simplicity	sl
Vzlic visoki starosti se pa vendar ni zmanjšala njegova divjost, česar bi sicer otrok o svojem roditelju ne smel zapisati.	Oče se je postaral. Kljub temu je ostal neprijazen.	simplicity	sl
Nekega jutra je Vester spet slišal, da se bližajo težki vojaški čevlji.	Nekega jutra so vojaki zopet prišli.	simplicity	sl
Urban vozi po ustaljeni poti v mestnem središču, ob kateri so največje mestne znamenitosti.	Urban vozi mimo največjih mestnih znamenitosti.	simplicity	sl
Te lepe in rosne nedelje zjutraj sta bila Černjakova dečka zelo slabe volje, ker sta morala zaradi paše zgodaj vstati, zato pa sta se iz jeze že navsezgodaj jela znašati nad siroto.	Neko nedeljo sta bila fanta zelo slabe volje. Zgodaj zjutraj sta začela tepsti terbo.	simplicity	sl
"""Marš na delo!"""	Marš na delo.	simplicity	sl
Matija Gosak je zagrabil presenečeno Lido za lase in začel na vso moč vpiti na pomoč.	Matija je zgrabil Lido za lase in začel klicati: Na pomoč, na pomoč!	simplicity	sl
Luka je precej časa zidal v Gorici in Trstu, zato mu je še ostalo nekaj italijanskih besed.	Luka je pred padcem zidal tudi v Italiji. Znal je nekaj italijanskih besed.	simplicity	sl
Ondi na njivi je kopal Zavratarjev Mihola.	Na polju zraven je na njivi kopal sosed.	simplicity	sl
Starega je zadela kap in so ga tri dni pozneje odnesli pod zemljo. Mati ni nič odlašala, peljala je štirinajstletno Lido k premožnemu kmetu, ki jo je takoj najel za pastirico.	Ko je bila stara 14 let, je Lidi umrl oče. Mati jo je peljala k bogatemu kmetu.	simplicity	sl
Romeo ugotovi, da bo pri Kapuletih na večerji sedela tudi Rozalinda.	Ugotovi, da bo na plesu tudi Rozalinda.	simplicity	sl
Bil sem star dvanajst let.	Bil sem star 12 let.	simplicity	sl
Tedaj je videl, da so po trgu prignali župnika.	Nekega dne je videl, da so po trgu prignali župnika.	simplicity	sl
Toda ker ga niso našli, so se kakor na ukaz zapodili proti farni cerkvi.	Ugotovili so, da zvoni na pokopališču.	simplicity	sl
Hodile so mimo vaške ženice.	Mimo so hodile vaške ženice.	simplicity	sl
Luka, ki si je bil že ogledal ves semenj in je zato vedel, kje prodajajo zvonce, mu je položil svojo edino šapo na rame in ga začel pehati skozi sejmarje; stresal ga je, da je divje cingljalo in grmel iz dna svojega trebuha:	Luka je Tantadruju povedal, kje jih prodajajo.	simplicity	sl
Strme je poslušala pravljico o Trnuljčici, ki je spala v stolpu brez vrat. Breda je gledala zdaj podobo zdaj učiteljico s širokimi očmi, nenadoma pa je kriknila in se zvrnila na tla v temo, ker je spet dobila napad.	Ko ji je učiteljica brala pravljico o Trnuljčici, je Breda dobila napad.	simplicity	sl
