anchor1	anchor2	alternative1	alternative2
Ma anche il bar era chiuso, e nessuno aprì.	Ma anche il bar era chiuso, e nessuno aprì.	Altri motociclisti correvano al suo fianco ma lei li superava tutti!	Altri motociclisti correvano vicino a lei, ma lei li superava tutti.
La nuvoletta Erica rispose che si trovavano nel Paese dello Zucchero Filato, via delle Nuvole di Zucchero Filato, una traversa di via dei Fiori di Zucchero Filato.	La nuvoletta Erica rispose che si trovavano nel Paese dello Zucchero Filato, in via delle Nuvole di Zucchero Filato, vicino a via dei Fiori di Zucchero Filato.	Benedetto era nel Gruppo numero tre con la sua amica, Margherita, e un ragazzo appena arrivato di nome Sandro.	Benedetto era nel Gruppo numero tre con la sua amica, Margherita, e un ragazzo appena arrivato di nome Sandro.
Quando finirono, il pubblico applaudì, ma tutti loro lo sapevano che non avevano vinto il trofeo.	Quando finirono, il pubblico applaudì, ma tutti loro lo sapevano che non avevano vinto la coppa.	Margherita diede un’occhiata al suo sacchetto vuoto e realizzò che c’era un buco sotto.	Margherita guardò il suo sacchetto vuoto e vide il buco nel fondo.
Il chiasso durante il viaggio era terribile.	C’era tanto chiasso sull’autobus.	Subito , Ernesta Sparalesta e Mauro ricevettero una medaglia al valore e Ernesta divenne un’eroina al servizio della Nazione, un vero e proprio agente speciale.	Subito , il Presidente diede a Ernesta Sparalesta e Mauro una medaglia al valore e Ernesta divenne un’eroina al servizio della Nazione, un vero e proprio agente speciale.
Sandro e Margherita inventarono nuovi suoni da gufo sbattendo le loro ali immaginarie tutte le volte che trovavano un nuovo indizio.	Sandro e Margherita inventarono nuovi suoni da gufo sbattendo le loro ali immaginarie tutte le volte che trovavano un nuovo indizio.	Poi, Gigi il fattore scelse due cani lupo per aiutarlo a fare la guardia al suo gregge di pecore.	Poi, Gigi il fattore scelse due cani lupo per aiutarlo a fare la guardia al suo gregge di pecore.
Quando gli abitanti del paese videro ciò che Ernesta e i suoi amici avevano fatto, rimasero a bocca aperta.	Quando gli abitanti del paese di “pì” videro quello che Ernesta e i suoi amici avevano fatto, furono molto sorpresi.	Ernesta prese una corda, si arrampicò fino alla cima del campanile, e finalmente recuperò il cappello.	Ernesta prese una corda, salì fino in cima al campanile, e trovò il cappello.
C’era un gran silenzio in paese quella notte.	In paese c’era un gran silenzio quella notte.	Era qualcosa di piccolo e di forma ovale, e somigliava tantissimo a un qualche tipo di uovo fossile.	Era qualcosa di piccolo e ovale, e somigliava tantissimo a un tipo di uovo che si era trasformato in un fossile.
Infine telefonò a Mario l’idraulico per farsi portare trecento tubi di plastica.	Ernesta telefonò anche a Mario l’idraulico e gli domandò di portare trecento tubi di plastica.	Era vivo!	Era vivo!
Quando lo zio Giorgio, lo zio di Clara, sentì che avevano annullato i loro piani per una vacanza in campeggio, propose che i bambini andassero a stare da lui.	Quando lo zio Giorgio, lo zio di Clara, sentì che non andavano in campeggio, disse che i bambini potevano andare a stare da lui.	Poi chiese a Luisa se poteva venire a vedere Dora, perché a lei non era permesso avere un gatto.	Clara non aveva un gatto, e chiese se poteva venire a vedere Dora.
Il Papà mandò la Mamma di sopra a stendersi e a riposarsi dopo colazione, mentre lui prendeva gli ultimi accordi per il pranzo della festa di compleanno della Mamma.	Il Papà mandò la Mamma di sopra a stendersi e a riposarsi dopo colazione, mentre lui faceva gli ultimi piani per il pranzo della festa di compleanno della Mamma.	Una volta arrivato a 6, trovò un bidone della carta quasi vuoto.	Quando arrivò a sei, trovò un bidone della carta quasi vuoto.
Le porte erano fatte di liquirizia e il campanello era fatto di caramello profumato.	Le porte erano fatte di liquirizia e il campanello era fatto di zucchero.	Ora, Margherita mette in un contenitore le sue gelatine, in modo da non farle più cadere per terra.	Ora, Margherita mette in un contenitore le sue gelatine, in modo da non farle più cadere per terra.
Ida capì che doveva salvarlo e coraggiosamente cominciò a nuotare con grande foga nell’acqua.	Ida coraggiosamente cominciò a nuotare con grande energia nel mare perché capì che doveva provare a salvarlo.	Sofia poi si guardò attorno e vide tutte le macchine e il loro autobus bloccati sulla strada dietro di loro.	Sofia poi si guardò attorno e vide tutte le macchine e il loro autobus bloccati sulla strada dietro di loro.
Sofia balzò in piedi impaurita, ma fortunatamente era solo Vincenzo, il suo gattino, che le faceva le fusa.	Sofia balzò in piedi impaurita, ma fortunatamente era solo il suo gattino Vincenzo che le faceva le fusa.	Da allora, se c’è un mistero da svelare o un problema da risolvere, tutti chiamano l’Agente Speciale Ernesta Sparalesta.	Da allora, se c’è un problema da risolvere, tutti chiamano l’Agente Speciale Ernesta Sparalesta.
Clara poi sorrise a Aidan e gli consegnò un enorme sacchetto di carta.	Clara poi sorrise a Aidan e gli diede un sacchetto di carta molto grande.	Il cappotto e le scarpe di Clara davano l’idea di non essere mai asciutti da settimane e la bambina aveva dovuto persino ritirare fuori i suoi vecchi stivali di gomma.	Il cappotto e le scarpe di Clara erano sempre bagnati a causa della pioggia e la bambina dovette indossare i suoi vecchi stivali di gomma.
A causa del comportamento di Margherita, Benedetto non era troppo contento dell’organizzazione del gruppo.A Benedetto piaceva Margherita, ma non gli piaceva per niente come trattava Sandro.	Benedetto non era troppo contento dell’organizzazione del gruppo, perché a Benedetto non piaceva per niente il modo in cui Margherita trattava Sandro.	Il Vecchio Tempesta si grattò ancora un po’ la testa, poi fece schioccare le dita e rapidamente scrisse ‘ambra grigia’ su Google.	Il Vecchio Tempesta si grattò ancora un po’ la testa, poi fece schioccare le dita e rapidamente scrisse ‘ambra grigia’ su Google.
Si ricordò che non c'erano alberi lì intorno che potevano fare quel rumore, perciò forse era un animale ferito?	Si ricordò che non c'erano alberi lì intorno che potevano fare quel rumore, forse era un animale ferito?	Mentre immaginava la torta infilò la forchetta in bocca.	Mentre pensava a questa torta mise la forchetta in bocca.
I due amici erano molto incuriositi e chiesero al cameriere il nome di quella specialità.	I due amici erano molto curiosi e chiesero al cameriere il nome di quel dolce.	Ida e il ragazzo avevano freddo ed erano impauriti, ma erano finalmente al sicuro, e fecero entrambi la promessa di non oltrepassare mai più il limite di profondità consentita.	Ida e il ragazzo avevano freddo ed erano impauriti, ma erano finalmente al sicuro, e fecero entrambi la promessa di non andare mai più nel mare troppo profondo.
Poi c’erano le mucche Maria e Susanna che muggivano disperatamente nella stalla, stringendosi intorno alla zia Anna e al suo secchio.	Poi c’erano le mucche, Maria e Susanna, che muggivano tristi nella stalla, attorno alla Zia Anna e al suo secchio.	Era tutto organizzato.	Era tutto organizzato.
Così il sindaco aveva stabilito che nei giorni pari non si uscisse in macchina, neppure per andare a scuola o al lavoro.	Così il sindaco aveva deciso che nei giorni pari non si doveva uscire in macchina, neanche per andare a scuola o al lavoro.	I ragazzi stavano bene insieme, considerato che era la prima volta che si incontravano.	I ragazzi stavano bene insieme, anche se questa era la prima volta che si incontravano.
Era giorno quando Clara riprese conoscenza.	Era giorno quando Clara riprese conoscenza.	Susanna voleva giocare e, non appena notò Sofia che si rinfrescava le mani nel laghetto, Susanna con aria felice saltò addosso a Sofia.	Susanna voleva giocare e con aria felice saltò addosso a Sofia, che si stava rinfrescando le mani nel laghetto.
Poi, uscì con prudenza dal bagno, evitò i buchi nel pavimento dove c’erano le tavole, e girò intorno ad un idraulico che accompagnava una canzone alla radio fischiettando in modo stonato.	Poi, uscì con prudenza dal bagno, evitò i buchi nel pavimento dove c’erano le tavole, e girò attorno ad un idraulico che cantava seguendo una canzone alla radio.	Vedeva sotto di sé i tetti della sua città.	Dall’alto vedeva i tetti della sua città.
Allo zoo, c’erano scimmie che saltavano dalle cime degli alberi, zebre che galoppavano lì intorno, e grandi orsi marroni seduti davanti alle loro tane.	Allo zoo, c’erano scimmie tra le cime degli alberi, zebre che correvano lì intorno, e grandi orsi marroni seduti davanti alle loro tane.	Curiosa com'era, si avvicinò per osservarla meglio, prima timidamente, poi con più coraggio.	Curiosa com'era, Ernesta si avvicinò per guardarla meglio, prima con paura, poi con più coraggio.
Nonna Magda si abbassò a raccogliere una pallina di carta di giornale e la aprì con cura.	Nonna Magda raccolse un pezzo di giornale e lo aprì con cura.	Collezionava i migliori dolci da tutto il mondo.	Collezionava i migliori dolci da tutto il mondo.
Il Sindaco fece tutto il necessario per convincere i cittadini ricchi e poveri a indossare i guanti di Madame Sciantosa: organizzò una grossa sfilata cittadina, pubblicò articoli su tutti i giornali parigini e ricoprì la città di pubblicità che esaltavano l’eleganza dei guanti di Madame Sciantosa.	Il Sindaco fece di tutto per convincere i cittadini ricchi e poveri a mettere i guanti di Madame Sciantosa: organizzò una grossa sfilata cittadina, pubblicò articoli su tutti i giornali parigini e ricoprì la città di pubblicità dei guanti di Madame Sciantosa.	Il papà di Luisa prese la mano di Tonio Battaglia, che sembrava scioccato, e la strinse a lungo.	Tonio Battaglia sembrava scioccato mentre il papà di Luisa continuava a stringergli la mano.
Probabilmente della taglia di un piccolo pony.	Era grande come un piccolo pony.	Al proprietario del banchetto piaceva la Vecchia Volpina, ma doveva venderla perché a sua moglie non era mai piaciuta.	All’uomo della bancarella piaceva la vecchia volpina, ma doveva venderla perché a sua moglie non era mai piaciuta.
La Nonna e il Nonno arrivarono giusto in tempo per il pranzo.	La Nonna e il Nonno arrivarono giusto in tempo per il pranzo.	In acqua c’era pure un gatto!	C’era un gatto nell’acqua!
Ernesta si ricordò allora del suo amico Mauro, un famoso scienziato che aveva inventato molte strane macchine, e così corse da Mauro per chiedere il suo aiuto.	Allora Ernesta pensò di chiedere aiuto al suo amico Mauro.Mauro era un famoso scienziato e aveva inventato molte strane macchine.	Così domandò ad Angelica il motivo di quel nome.	Così domandò ad Angelica il motivo di quel nome.
La volpe era in pezzi e intorno ad Alberto c’era un mucchio di imbottitura e di vecchi giornali accartocciati.	La volpe era in pezzi e intorno ad Alberto c’erano pezzi di un vecchio giornale e dell’imbottitura.	All’improvviso l’autobus si fermò, perché qualcosa bloccava la strada davanti a loro.	All’improvviso l’autobus si fermò, perché qualcosa bloccava la strada davanti a loro.
Dopotutto, rimpicciolire la gente non era poi un’idea così brillante.	Rimpicciolire la gente non era poi tanto una buona idea.	Dopo una settimana di navigazione, Ernesta e la sua nuova cagnetta Chiazza avvistarono un asteroide bianco e nero.	Dopo una settimana di viaggio, Ernesta e la sua nuova cagnetta Chiazza videro un piccolo pianeta bianco e nero.
“Aaaaahhhh”, Clara urlò come sentì il suo corpo cadere.	“Aaaaahhhh”, Clara urlò quando cadde.	Tutti provarono a rallegrare la Mamma in ogni modo, ma non servì a nulla.	Tutti provarono a rallegrare la Mamma in ogni modo, ma non servì a nulla.
I bambini non furono convinti dalla sua risposta, quindi corsero fino alla fermata dell’autobus a chiedere a qualcun altro un secondo parere.	I bambini non erano sicuri della sua risposta, quindi corsero fino alla fermata dell’autobus a chiedere a qualcun altro.	Ugolino, meno convinto di Pietro, chiuse gli occhi e pensò intensamente ai frutti di bosco che tanto gli piacevano.	Ugolino, meno convinto di Pietro, chiuse gli occhi e pensò ai frutti di bosco che gli piacevano tanto.
La notte prima c’era stato un grosso temporale e i bambini decisero di andare alla ricerca di conchiglie e pietre, e di qualunque cosa di interessante sulla spiaggia.	La notte prima c’era stato un grosso temporale e i bambini volevano andare alla ricerca di conchiglie e pietre, e di altre cose interessanti sulla spiaggia.	Da quel giorno, per non correre più rischi Ugolino lesse sempre con attenzione tutte le etichette.	Da quel giorno, per non passare altri guai, Ugolino lesse sempre con attenzione tutte le etichette.
Il rumore era simile a qualcuno che masticava qualcosa di succoso.	Il rumore era simile a qualcuno che mangiava qualcosa di succoso.	Tutti gli altri micini avevano trovato nuove famiglie e questo era l’ultimo rimasto!	Tutti gli altri micini avevano trovato nuove famiglie e questo era l’ultimo rimasto!
Ida non era sicura che le poteva piacere nuotare nel mare agitato.	Ida non era sicura che le poteva piacere nuotare nel mare agitato.	Prima, passò da Luigi l’elettricista e gli chiese di procurare un bel rotolo di filo elettrico.	Prima andò da Luigi l’elettricista e gli chiese di prendere un bel rotolo di filo elettrico.
Poiché era indeciso su quale fosse il bidone giusto, chiese ad un passante di indicargli il bidone dove buttare la carta.	Poiché non sapeva quale fosse il bidone giusto, chiese ad un signore che passava dove era il bidone per la carta.	Poiché anelli, orologi e bracciali erano nascosti dai guanti di Madame Sciantosa, nessuno fu più in grado di fare distinzioni tra poveri e ricchi.	Poiché anelli, orologi e bracciali erano nascosti dai guanti di Madame Sciantosa, nessuno riuscì più a capire chi era ricco e chi era povero.
Il proprietario del bar era molto simpatico e mentre Emanuele gli raccontava del loro trasloco, Luisa gironzolava fuori dal bar per mangiare il gelato in pace.	Il proprietario del bar era molto simpatico e mentre Emanuele gli raccontava del loro trasloco, Luisa uscì fuori dal bar per mangiare il gelato in pace.	Simo si avvicinò per vedere meglio, ma come si avvicinò si rese conto che c’era qualcuno sulla barca, perché un’ombra enorme apparve all’improvviso alle sue spalle e gli diede una spinta con violenza.	Simo si avvicinò per vedere meglio, ma come si avvicinò, si rese conto che c’era qualcuno sulla barca, perché un’ombra enorme apparve all’improvviso alle sue spalle e gli diede una spinta con violenza.
I bambini si guardarono.	I bambini si guardarono.	La strada era un po’ dissestata e si avvicinavano con lentezza alla casetta di zia Anna dove stavano andando.	La strada era un po’ dissestata e si avvicinavano con lentezza alla casetta di zia Anna dove stavano andando.
Era il bullo del quartiere, Tonio Battaglia.	Era Tonio Battaglia, un orribile ragazzo della sua scuola.	Aveva la stessa carnagione e lo stesso naso appuntito.	Aveva la stessa carnagione e lo stesso naso appuntito.
Respiravano tutti in modo affannoso perché tutti erano molto concentrati, ma finalmente i tiranti furono fissati e ogni cosa fu al suo posto.	Tutti erano molto presi dal lavoro e il lavoro era duro, ma finalmente la tenda fu montata.	La Signorina Bottoni indossava un grande cappello di paglia viola, così i bambini la potevano riconoscere facilmente.	La Signorina Bottoni indossava un grande cappello di paglia viola, così che era facile per i bambini notarla.
E anche punire il Signor Rossi non aveva senso.	E anche punire il Signor Rossi non aveva senso.	Avvolsero il sasso a forma di uovo accuratamente nella camicia di Benedetto e si precipitarono da Dino, il guidatore di autobus in pensione, che portava a spasso il suo cane, Samuele.	Misero il sasso a forma di uovo nella camicia di Benedetto e corsero da Dino, il vecchio guidatore di autobus, che portava a spasso il suo cane, Samuele.
Tirò su il braccio e gli cadde in mano.	Tirò su il braccio e gli cadde in mano.	Anche la mamma di Emanuele era lì e parlava con l’anziana signora del suo micino.A giudicare dallo sguardo negli occhi della mamma, Emanuele si chiedeva felice se ci sarebbe stato un nuovo animaletto nella loro famiglia!	La mamma di Emanuele era lì e, mentre parlava con l’anziana signora del suo micino, sembrava proprio che volesse portare il micino a casa con lei e Emanuele!
Anche quel giorno aveva portato la cagnolina con sé, sulla sua bicicletta speciale in viaggio verso lo spazio.	Anche quel giorno aveva portato la cagnolina con sé, sulla sua bicicletta speciale in viaggio verso lo spazio.	Era molto entusiasta.	Era molto contenta.
Era così impegnata ad osservare gli animali nello zoo che non si accorse che il suo sacchetto aveva sul fondo un minuscolo buco.	Era così impegnata a guardare gli animali nello zoo che non vide che il suo sacchetto aveva un minuscolo buco.	Sugli scaffali c’erano bibite di tutti i tipi: con le bollicine, senza le bollicine, succhi di frutta, bibite zuccherine, bibite sconosciute e bibite speciali.	C’erano bibite di tutti i tipi: con le bollicine, senza le bollicine, succhi di frutta, bibite dolci, bibite sconosciute e bibite speciali.
Poteva essere quasi carino se restava così, pensò Luisa.	Luisa pensò che Tonio poteva essere quasi carino se restava così.	Si mise addosso una giacca a vento e una sciarpa e iniziò a cercare il cappello dappertutto, attorno al luogo della conferenza..	Ernesta si vestì con una giacca a vento e una sciarpa e uscì.Cercò dappertutto dove il Presidente aveva fatto il suo discorso.
Effy rimase sotto la doccia per moltissimo tempo e per il resto del giorno non ci furono più scherzi.	Effy rimase sotto la doccia per moltissimo tempo e per il resto del giorno non ci furono più scherzi.	Ma non c’era più nessuno e sul banchetto c’era un biglietto con su scritto ‘categoria completa’, e quindi Effy non avrebbe più potuto iscriversi alla gara.	Ma non c’era più nessuno e sul banchetto c’era un biglietto con su scritto ‘categoria completa’, e quindi Effy non avrebbe più potuto iscriversi alla gara.
“Sei fortunata”, disse ad Effy la donna al banchetto, “Sei l’ultima concorrente per oggi. Le iscrizioni stanno per chiudersi.”	“Sei fortunata”, disse ad Effy la donna al banchetto, “Sei l’ultima persona ad iscriversi oggi.Le iscrizioni stanno per chiudersi.”	Susanna era tutta muscoli e Sofia non aveva visto arrivare Susanna, quindi fu sbalzata per aria in un attimo.	Susanna era molto forte e Sofia non aveva visto arrivare Susanna, quindi fu travolta in un attimo.
Si sentiva persa nel suo accogliente letto di legno e le sue braccia non erano più lunghe abbastanza per prendere la sua tazza di tè in mano.	Si sentiva persa nel suo accogliente letto di legno e le sue braccia non erano più lunghe abbastanza per prendere la sua tazza di tè in mano.	Clara era raggiante di gioia.	Clara sorrise.
Sofia voleva un gatto ma Benedetto voleva un cane.	Sofia voleva un gatto ma Benedetto voleva un cane.	Avevano degli amici per sempre.	Avevano degli amici per sempre.
Ida, Simo e Aidan guardavano con stupore il contenuto denso e maleodorante del gabinetto mentre schizzava fuori dal tubo - tutto addosso ad Effy.	Ida, Simo e Aidan guardavano sorpresi il contenuto denso e puzzolente del gabinetto sparato fuori dal tubo - tutto addosso ad Effy.	“No”, urlò Ida, e corse verso la barca, ma era troppo tardi perché la barca era già in mare.	Ida urlo’ “No!”, e corse verso la barca, ma era troppo tardi perché la barca era già in mare.
Stava proprio passando davanti alla porta del bagno quando all’improvviso mise un piede nel... vuoto!	Dopo che Clara superò il bagno, cadde improvvisamente in un ... buco!	Una bella e fresca mattina d’estate i due gemelli, Benedetto e Sofia, presero l’autobus diretto al mare con i loro amici, Sandro e Margherita.	Era una bella e fresca mattina d’estate, e i due gemelli, Benedetto e Sofia, presero l’autobus diretto al mare con i loro amici, Sandro e Margherita.
Benedetto e Sofia erano gemelli.	Benedetto e Sofia erano fratello e sorella.	Lo Zio Giuseppe prese dalla sala alcune sedie in più, in modo che potessero tutti sedersi intorno al grande tavolo rotondo della cucina.	Lo Zio Giuseppe prese dalla sala alcune sedie in più, in modo che potessero tutti sedersi intorno al grande tavolo rotondo della cucina.
Emanuele amava i cani!	Infatti, Emanuele amava i cani!	Gli disse di prendersi tutti i dolcetti che voleva.	Gli disse di prendersi tutti i dolcetti che voleva.
Si sentì ancora peggio quando si guardò il braccio rotto; era ricoperto dal polso al gomito da un gesso color viola.	Si sentì ancora peggio quando vide che si era rotta il braccio; era ricoperto da un gesso color viola.	Metà della bella e lunga treccia di Clara era caduta, proprio sulla parte dietro al sedile dove si era seduta Clara.	Luisa vide che metà della bella lunga treccia di Clara era caduta, proprio sulla parte dietro al sedile dove si era seduta Clara!
Un giorno d’estate faceva molto caldo e Ugolino aveva davvero tanta sete.	Un giorno d’estate faceva molto caldo e Ugolino aveva davvero tanta sete.	Margherita aveva una fissa per le persone con gli occhiali, e prendeva in giro Sandro da quando era arrivato.	A Margherita piacevano le persone con gli occhiali, e prendeva in giro Sandro da quando era arrivato.
Al contrario, queste persone avevano ammucchiato troppa spazzatura ovunque.	Infatti, avevano ammucchiato troppa spazzatura ovunque.	Grazie a quel sistema per raffreddare l’aria, le nuvolette non dovettero mai più partire e lasciare né gli amici, né le loro case.	Grazie a quel sistema per raffreddare l’aria, le nuvolette non dovettero mai più lasciare le loro case e i loro amici.
I due cagnetti si assomigliavano davvero tanto e si comportavano come se si conoscessero da sempre.	I due cagnetti si assomigliavano molto.Sembrava che si conoscessero.	Ma Sofia disse che non voleva fare del male a Susanna, perché era solo un cane e non poteva agire diversamente.	Ma Sofia disse che non voleva fare del male a Susanna, perché era solo un cane e non poteva agire diversamente.
Che cosa era successo?	Che cosa era successo?	Le gelatine di Margherita cadevano per terra ogni due passi che faceva.	Le gelatine di Margherita cadevano per terra ogni due passi che faceva.
Guardò in alto il cielo e la sua famiglia che stava in piedi intorno a lei.	Guardò in alto il cielo e la sua famiglia che stava in piedi intorno a lei.	L’uomo saltò su per il grande spavento con il tubo ancora in mano.	L’uomo fece un salto per il grande spavento con il tubo ancora in mano.
All’improvviso, Sofia scoppiò in una risata.	All’improvviso, Sofia scoppiò in una risata.	Simo era alla prima vacanza in campeggio con sua sorella maggiore Ida.	Simo era alla prima vacanza in campeggio con sua sorella maggiore Ida.
Sandro e Margherita seguirono Tito fino alla gabbia delle scimmie, dove trovarono la Signorina Bottoni e Mamma Gorilla tutte e due preoccupatissime alla loro ricerca.	Sandro e Margherita seguirono Tito fino alla gabbia delle scimmie, dove si trovavano la Signorina Bottoni e Mamma Gorilla preoccupatissime, che li stavano cercando.	I bambini trovarono la Signora Ortica che sonnecchiava sulla panchina, così la svegliarono con delicatezza e le mostrarono la loro scoperta.	I bambini trovarono la Signora Ortica addormentata sulla panchina, così la svegliarono con delicatezza e le mostrarono la loro scoperta.
Le due ragazze uscirono.	Clara e Luisa uscirono.	Ma Margherita riusciva a capire che Sandro era un bravo ragazzo e con un senso dell’umorismo simile al suo.	Ma Margherita riusciva a capire che Sandro era un bravo ragazzo e che aveva lo stesso senso dell’umorismo.
Alla fine di ogni gara, Benedetto le dava sempre dei colpetti affettuosi sulla spalla facendole un discorsetto benevolo su vincitori e vinti.	Dopo ogni gara, Benedetto le dava sempre dei colpetti affettuosi sulla spalla facendole un discorsetto benevolo su vincitori e vinti.	Ma il cappello sembrava sparito nel nulla.	Ma anche lei non riuscì a trovare il cappello.
Accanto a quel che rimaneva del grande tendone, segni di bruciato correvano sull’erba e un solco scavato dal fuoco partiva dall’albero di quercia andato a fuoco in direzione dei pali del tendone.	Accanto ai pezzi della grande tenda, c’era una linea di bruciato nell’erba tra la tenda e il vecchio albero che era stato colpito dal fulmine.	Luisa cercava di non dimostrarlo, ma a volte tutto quello che desiderava era essere di nuovo nella sua vecchia casa con la sua migliore amica Emma.	Qualche volta Luisa avrebbe voluto essere di nuovo nella sua vecchia casa, con la sua migliore amica Emma.
Alla porta c’era il nipote della Mamma, Tommaso, che portava una grossa torta alla mousse di cioccolato con quaranta candeline sopra.	Alla porta c’era Tommaso, il nipote di Mamma, che teneva in mano una grossa torta alla mousse di cioccolato con quaranta candeline sopra.	Una volta, Ernesta Sparalesta capitò in uno strano paese assieme ai suoi inseparabili amici: Luigi l’elettricista, Mario l’idraulico, Nicola l’imbianchino e Antonio il pescivendolo.	Una volta, Ernesta Sparalesta arrivò in uno strano paese assieme ai suoi cari amici: Luigi l’elettricista, Mario l’idraulico, Nicola l’imbianchino e Antonio il pescivendolo.
Guardando fuori dalla finestra, vide suo fratello Benedetto che lottava contro il vento.	Guardò fuori dalla finestra, e vide suo fratello Benedetto che stava cercando di camminare nel vento forte.	“ALBERTO!!” urlò Alì.	“ALBERTO!!” urlò Alì.
Così, quando Emanuele si offrì di portare a spasso Alberto, Ali accettò molto riconoscente.	Così, quando Emanuele disse che voleva portare a spasso Alberto, Ali disse di sì con piacere.	Sfidava Sofia persino a chi arrivava per primo dal dentista.	Sfidava Sofia persino a chi arrivava per primo dal dentista.
La pasticceria era di una donna molto sorridente di nome Clara, che era una fanatica dei dolci.	La pasticceria era di una donna molto sorridente di nome Clara, che era molto amante dei dolci.	Disse che non era sicuro di quello che era.	Disse che non era sicuro di quello che era.
Con uno scatto attraversò la spiaggia in direzione delle rocce per vedere meglio i delfini.	Attraversò la spiaggia correndo in direzione delle rocce per vedere meglio i delfini.	Era nervosa, ma strisciò in avanti e aprì la lampo della tenda.	Era nervosa, ma strisciò verso l'uscita e aprì la lampo della tenda.
Alcuni dicono che portò Susanna a una scuola per cani, addirittura.	Alcuni dicono che portò Susanna a una scuola per cani, addirittura.	Grazie a questi calcoli e a queste misure, Mauro scoprì che il cappello doveva essere finito in cima al campanile.	Così scoprì che il cappello era finito sul campanile.
Poi Ernesta pensò di correre veloce tra le onde del mare e la bicicletta divenne un motoscafo in un mare azzurro cristallino, dalle onde spumeggianti.	Poi Ernesta pensò di correre veloce tra le onde del mare.Allora la bicicletta diventò una barca che correva sulle onde del mare.	L’ometto barbuto si presentò dicendo che era il Nano dell’Isola, l’attuale custode delle Isole Britanniche.	L’ometto barbuto disse che lo chiamavano il Nano dell’Isola, e che lui era la persona che aveva cura delle Isole Britanniche.
In un primo momento, voleva fare del male alla cagna.	In un primo momento, voleva fare del male alla cagna.	Ma arrivati in fondo alla strada, era già tranquillo.	Ma Emanuele si tranquillizzò quando arrivarono in fondo alla strada.
Mauro era molto affezionato ad Ernesta.	Mauro voleva molto bene ad Ernesta.	Poi, all’improvviso, Sandro e Margherita sentirono un rumore strano dietro di loro.	Poi, all’improvviso, Sandro e Margherita sentirono un rumore strano dietro di loro.
A parte i dolci allo scarabeo, Aidan contava di assaggiare tutti i tipi di dolci dell’intero negozio entro la fine della vacanza.	Oltre ad assaggiare i dolci allo scarabeo, Aidan contava di assaggiare tutti i tipi di dolci dell’intero negozio entro la fine della vacanza.	Erano secoli che non vedevano la nonna, e succedeva sempre qualcosa quando lei veniva.	Era da tanto tempo che non vedevano la nonna, e succedeva sempre qualcosa quando lei veniva.
Clara, Tommaso e Benedetta erano fuori a osservare un airone che si tuffava in cerca di pesci, quando videro qualcosa che si dimenava in acqua vicino all’ansa del fiume.	Clara, Tommaso e Benedetta erano fuori a osservare un airone che pescava, quando videro qualcosa nell’acqua.	Luisa avrebbe mantenuto i contatti con i suoi amici, specialmente con la sua migliore amica Emma, ma avrebbe sentito la mancanza del fare le cose in campagna – vedere gli agnellini nascere, nuotare nel fiume e rotolarsi giù dal bosco lungo la collina a gran velocità – tanto per dirne alcune.	Luisa voleva restare in contatto con i suoi amici, specialmente con la sua migliore amica Emma, ma avrebbe sentito la mancanza anche del fare le cose in campagna.Per esempio, le sarebbe mancato vedere gli agnellini nascere, e avrebbe sentito la mancanza di andare a nuotare nel fiume e di rotolarsi giù dal bosco lungo la collina a gran velocità.
Effy rise.	Effy rise.	Poi, Ida guardò verso il mare aperto e vide una nave di legno dall'aspetto antico, con bianche vele ondeggianti.	Poi, Ida guardò verso il mare aperto e vide una nave di legno dall'aspetto antico, con vele bianche gonfiate dal vento.
“Sono Angelica e vivo qui nel paese di “pì”.	“Sono Angelica e vivo qui nel paese di “pì”.	Quando finalmente riuscì a liberarsi dalla tenda, vide una ragazza con i capelli biondi e ricci che stava in piedi sopra di lei.	Quando finalmente uscì fuori dalla tenda, vide una ragazza con i capelli biondi e ricci che stava in piedi sopra di lei.
Non vedeva proprio l’ora.	Non vedeva proprio l’ora di rivederla.	Luisa e Clara si erano appena messe a chiacchierare e Luisa stava timidamente mostrando a Clara una foto della nuova micina di famiglia, Dora, quando le due ragazze si guardarono terrorizzate – la signora Perticoni aveva tolto di peso Tonio Battaglia dagli ultimi posti e lo aveva sbattuto giù proprio dietro di loro.	Luisa e Clara si erano appena messe a chiacchierare e Luisa stava mostrando a Clara una foto della nuova micina di famiglia, Dora, quando le due ragazze si guardarono terrorizzate – la signora Perticoni aveva spostato Tonio Battaglia dagli ultimi posti e lo aveva messo a sedere proprio dietro di loro.
Nel frattempo, Benedetto e Luca decisero di fare una gara prendendo posizione sulle piattaforme una e due.	Poi Benedetto e Luca decisero di fare una gara prendendo posizione sulle piattaforme una e due.	Anche Margherita è diventata più attenta.	Anche Margherita è diventata più attenta.
Tito, nel frattempo, decise di tornare dalla sua mamma.	Mentre Margherita guardava il sacchetto, Tito tornò indietro dalla sua mamma.	Vagamente ricordava qualcosa di simile a questo materiale, perché tanto tempo prima, stando seduto sulla sabbia, un amico di un amico aveva trovato qualcosa di simile a questo.	Poteva ricordare qualcosa di simile a questo materiale, perché tanto tempo prima, un amico di un amico aveva trovato qualcosa di simile a questo nella sabbia.
Da allora, non ci furono più giornate noiose per Ernesta: in sella alla sua bicicletta di legno, Ernesta Sparalesta attraversò il mondo e lo spazio, e visse mille avventure.	Da allora, non ci furono più giornate noiose per Ernesta: con la sua bicicletta di legno, Ernesta Sparalesta viaggiò dappertutto e visse mille avventure.	La mamma di Luisa aveva preparato dei dolcetti al cioccolato bianco.	La mamma di Luisa aveva preparato dei dolcetti al cioccolato bianco.
Era grande e faceva un bel po’ di chiasso.	Era grande e si muoveva in modo agitato.	Pensò di volare sopra i tetti della città.Puntò ancora una volta i piedi a terra e si spinse in avanti a tutta velocità, con la testa bassa, ben incassata fra le spalle.	Mentre pensava di volare sopra i tetti della città, spinse i piedi a terra, e si mise a correre veloce con la bicicletta.
Ancora oggi, tutti gli abitanti sono riconoscenti ad Ernesta perché ha trasformato il piccolo “pì” in “Pìpof”, il paese gemello di Papòf.	Ancora oggi, tutti gli abitanti del piccolo paese sulla montagna sono felici perché Ernesta ha trasformato il vecchio paese di “pì” in “Pìpof”, il paese gemello di Papòf.	Proprio mentre giravano l’angolo verso il fiume, Emanuele sentì un tonfo e un suono simile ad un acuto miagolio.	Mentre giravano l’angolo verso il fiume, Emanuele sentì un tonfo e un suono acuto come di un pianto.
Lungo la strada, quando passarono davanti al mercato, nonna Magda si fermò perché qualcosa attirò la sua attenzione.	Lungo la strada, quando passarono davanti al mercato, nonna Magda si fermò perché vide qualcosa di interessante.	In quel momento Effy corse dietro l’uomo, fece un respiro profondo e si lanciò con la nota più alta e forte che poteva tirar fuori.	In quel momento Effy corse dietro l’uomo, fece un respiro profondo e cantò con la nota più alta e forte che poteva tirar fuori.
La proprietaria del cappello passò accanto agli alligatori, passò accanto alla Casa del Veleno, poi la proprietaria del cappello girò a sinistra dritta dentro all’acquario.	La proprietaria del cappello passò accanto agli alligatori, passò accanto alla Casa del Veleno, poi la proprietaria del cappello girò a sinistra dentro all’acquario.	Benedetto non aveva mai perso prima, avendo sempre gareggiato con bambini che erano più piccoli e più lenti di lui.	Benedetto non aveva mai perso prima, perché aveva sempre gareggiato con bambini che erano più piccoli e più lenti di lui.
Rimpianse di non aver preso una torcia.	Avrebbe voluto avere una torcia, ma non ne avevano portata una con loro.	Guardò indietro verso di lui con occhi imploranti, e Aidan capì che voleva essere seguita.	Guardò indietro verso di lui con occhi tristi, e Aidan capì che voleva essere seguita.
Pensò alle stelle, e questa volta la bicicletta si trasformò in una minuscola navicella lanciata nello spazio siderale.	Poi, Ernesta pensò alle stelle.Questa volta la bicicletta si trasformò in una nave spaziale.	Il Papà nascose immediatamente la torta nel frigorifero.	Il Papà nascose immediatamente la torta nel frigorifero.
Aveva occhi brillanti color blu scuro e un costante sorriso di chi una ne fa e cento ne pensa.	Aveva occhi brillanti color blu scuro e un costante sorriso di chi una ne fa e cento ne pensa.	Rise di nuovo.	Rise di nuovo.
Dopo aver preso piccone, corda e ganci, si diresse verso la montagna.	Dopo aver preso piccone, corda e ganci, andò verso la montagna.	Dopotutto, era anche comoda… Prima provò a spingersi con i piedi lentamente, piano piano.	Dopotutto, era anche comoda...Provò prima a spingere con i piedi piano piano.
Non ci fu soluzione migliore.	Questa fu la soluzione migliore.	Quando Emanuele era in piedi, Alberto gli arrivava fino al petto.	Quando Emanuele era in piedi, Alberto gli arrivava fino al petto.
Anche Luca e Michele erano gemelli, solo di un anno più grandi di Sofia e Benedetto.	Anche Luca e Michele erano gemelli, solo di un anno più grandi di Sofia e Benedetto.	La febbre causata dalla varicella era sparita, ma Sofia si sentiva debole e alcuni dei suoi puntini rossi le prudevano ancora.	La febbre della varicella era sparita, ma Sofia si sentiva debole e alcuni dei suoi puntini rossi le prudevano ancora.
Era incredibile a vedersi: i delfini che spingevano da un lato e l’uomo dall’altro.	Era incredibile vedere i delfini che spingevano da un lato e l’uomo dall’altro.	Ida seguì Simo fin sulla spiaggia affondando i piedi nella sabbia calda.	Ida seguì Simo fin sulla spiaggia e affondò i piedi nella sabbia calda.
Appena Clip vide il suo amato cappello, corse incontro ad Ernesta e Mauro per abbracciarali.	Clip ringraziò Ernesta e Mauro:	Così decise subito di aiutarla a ritrovare il cappello scomparso.	Così decise subito di aiutarla a ritrovare il cappello scomparso.
A Margherita piacevano molto i dolci, e portava con sé un bel sacchetto di caramelle di gelatina di frutta rosa e blu.	A Margherita piacevano molto i dolci, e aveva un bel sacchetto di caramelle di gelatina di frutta rosa e blu.	La barca sembrava abbandonata, così Simo fece un grosso balzo e atterrò sul ponte con un tonfo.	La barca sembrava abbandonata, così Simo fece un grosso balzo e atterrò sul ponte con un tonfo.
Ernesta Sparalesta è una bambina alta, più o meno, un metro e una noce.	Ernesta Sparalesta è una bambina alta poco più di un metro.	Raccontò a Ugolino delle recenti vicende parigine.	Raccontò a Ugolino cosa era successo a Parigi.
La Mamma ricambiò lo sguardo dei gemelli, sorridendo, mise il cane e il gatto nel bagagliaio, e li portò tutti a casa in macchina per finire di fare la torta di compleanno.	La Mamma guardò i gemelli.Sorrise e mise il cane e il gatto nel bagagliaio, e li portò tutti a casa in macchina per mangiare la torta di compleanno.	Ugolino Scellino era un grande esploratore.	Ugolino Scellino era un grande esploratore.
“Ciao! Mi chiamo Erica e questa è la mia casa. Benvenuti!” disse la nuvoletta ad Ernesta.	“Ciao! Mi chiamo Erica e questa è la mia casa. Benvenuti!” disse la nuvoletta ad Ernesta.	Benedetto e Sofia amavano tutti e due far confusione e andavano molto d’accordo tra loro, come ben succede tra fratelli e sorelle.	Benedetto e Sofia amavano far confusione e andavano molto d’accordo tra loro, come ben succede tra fratelli e sorelle.
Ida e Aidan gesticolavano come impazziti per richiamare l’attenzione dei due poliziotti, rossi in viso, che correvano lungo la spiaggia, e esultarono quando i poliziotti bloccarono l’uomo sulla sabbia bagnata e lo ammanettarono con le mani dietro la schiena per arrestarlo.	Ida e Aidan gesticolavano come impazziti per richiamare l’attenzione dei due poliziotti, rossi in viso, che correvano lungo la spiaggia, e esultarono quando i poliziotti spinsero l’uomo sulla sabbia bagnata e lo ammanettarono con le mani dietro la schiena per arrestarlo.	Ugolino e Pietro non avevano mai assaggiato dolci tanto deliziosi!	Ugolino e Pietro non avevano mai mangiato dolci deliziosi così buoni!
I figli della Zia Anna, Tommaso e Giacomo, aiutarono Sofia e Benedetto a preparare la tavola, mentre il Papà tirò fuori dal forno il tacchino ripieno.	I figli della Zia Anna, Tommaso e Giacomo, aiutarono Sofia e Benedetto a preparare la tavola, mentre il Papà tirò fuori dal forno il tacchino ripieno.	Non appena si svegliò, Sofia si rese conto che qualcosa era cambiato.	Sofia si era appena svegliata e capì che qualcosa era cambiato.
Il ragazzo veniva sempre più trasportato al largo dalla corrente e sembrava terrorizzato.	Il ragazzo veniva sempre più trasportato al largo dalla corrente e sembrava terrorizzato.	Stavano ancora discutendo quando arrivò un temporale.	Mentre stavano ancora discutendo, arrivò un temporale.
Emanuele raccolse il fagotto bagnato fradicio e lo avvolse delicatamente nel suo maglione.	Emanuele raccolse il gatto bagnato e lo mise delicatamente nel suo maglione.	C’erano dolci provenienti dall’India, dal Giappone e dall’America; c’erano persino dolci di una piccola tribù dell’Amazzonia.	C’erano dolci provenienti dall’India, dal Giappone e dall’America; c’erano persino dolci di una piccola tribù dell’Amazzonia.
